necesito saber cuántas personas han muerto por corona virus en italia	intent:latest_numbers
por favor, dime el número de muertes diarias en la comunidad de madrid	intent:latest_numbers
mira a ver si me puedes decir cuántas muertes hay ya en españa	intent:latest_numbers
quiero la última información de cuántas muertes hay en el mundo causadas por corona virus	intent:latest_numbers
dime si puedes una actualización del número de muertos en españa	intent:latest_numbers
si tienes un momento, dime cuál es el número de casos de corona virus en inglaterra	intent:latest_numbers
total de muertes por covid en el mundo	intent:latest_numbers
cuántas muertes ha habido por coronavirus en puebla	intent:latest_numbers
en qué porcentaje se incrementaron los casos de coronavirus desde enero	intent:latest_numbers
estadísticas del covid para méxico	intent:latest_numbers
cuántos infectados de coronavirus hay en el país	intent:latest_numbers
qué país tiene más infectados por covid	intent:latest_numbers
en dónde ha habido más muertos por covid	intent:latest_numbers
estadísticas de infectados por covid según género	intent:latest_numbers
quiénes se infectan más por covid	intent:latest_numbers
dime cuántos casos hay en españa a la fecha	intent:latest_numbers
dime el número de muertes a nivel mundial de coronavirus	intent:latest_numbers
cuántos enfermos de coronavirus hay en total	intent:latest_numbers
casos confirmados de coronavirus en el mundo	intent:latest_numbers
total de fallecimientos por covid-19	intent:latest_numbers
dime el número de personas infectadas en méxico	intent:latest_numbers
cuál es la número de muertos por coronavirus en méxico	intent:latest_numbers
dame el número de pacientes que ingresaron al hospital 20 de noviembre por covid-19	intent:latest_numbers
cuántos casos positivos se registraron el día de hoy	intent:latest_numbers
a cuántos números asciende el número de muertos por covid-19 en el mundo	intent:latest_numbers
cuántos muertos oficiales hay de coronavirus en españa	intent:latest_numbers
el número de pacientes dados de alta en esta semana por favor	intent:latest_numbers
ha habido nuevos casos de coronavirus en china el día de hoy	intent:latest_numbers
porcentaje de personas infectadas que necesitan hospitalización en méxico	intent:latest_numbers
cuántos casos hay en perú	intent:latest_numbers
cómo va la curva de contagiados en latinoamérica	intent:latest_numbers
cuántas muertes han habido por covid en nueva york	intent:latest_numbers
hay casos en bolivia	intent:latest_numbers
dime cuál es la curva de contagio en chile	intent:latest_numbers
cuántos decesos han habido por coronavirus en ecuador	intent:latest_numbers
cuántas personas han muerto por covid en alemania	intent:latest_numbers
cuántas personas se han recuperado de covid en chile	intent:latest_numbers
cuál es la cifra del total de recuperados en el mundo	intent:latest_numbers
dame las estadísticas de la enfermedad en españa	intent:latest_numbers
mostrame la cantidad de muertes en agentina por el corona virus	intent:latest_numbers
cuántos casos de nuevos enfermos hubo en china hoy	intent:latest_numbers
me mostrás las estadísticas actuales sobre el corona virus en argentina	intent:latest_numbers
cuál es la tasa de muerte del corona en brasil	intent:latest_numbers
por favor, estadísticas actuales sobre enfermos en uruguay	intent:latest_numbers
me gustaría saber cuánta gente murió de corona virus en el último mes	intent:latest_numbers
hubo muertes por corona virus hoy en china	intent:latest_numbers
dime el número total de recuperados de covid19	intent:latest_numbers
dame datos numéricos del covid19 en italia	intent:latest_numbers
informe sobre fallecidos por covid19 hoy en españa	intent:latest_numbers
cantidad de personas con coronavirus en latinoamérica	intent:latest_numbers
cuál es el número de recuperados por covid en usa	intent:latest_numbers
nación con más contagiados de coronavirus en el mundo	intent:latest_numbers
tasa de fallecimiento en contagiados por covid19 en el mundo	intent:latest_numbers
quiero ver las estadísticas de infectados en latinoamérica	intent:latest_numbers
cuántas personas en todo el mundo tienen coronavirus	intent:latest_numbers
cuántos casos de infectados tuvimos ayer en argentina	intent:latest_numbers
mostrame estadísticas comparadas de los infectados en cada país de latinoamérica	intent:latest_numbers
necesito saber el número de casos en australia	intent:latest_numbers
hay casos de infectados en la pampa	intent:latest_numbers
murió alguna persona de coronavirus en finlandia	intent:latest_numbers
por favor, decime el número total de muertes en el mundo por coronavirus	intent:latest_numbers
cuantos casos nuevos de corona hubo hoy	intent:latest_numbers
cuantos casos nuevs hubo hoy en colombia	intent:latest_numbers
quiereo saber el número de muertos por el virus en colombia	intent:latest_numbers
dame la cantidad de muertes hoy en inglaterra	intent:latest_numbers
cuáles son las cifras del coronavirus para hoy	intent:latest_numbers
qué número de fallecidos por el corona hay hasta el momento	intent:latest_numbers
cuál es la estadística actual del covid-19 en nueva zelanda	intent:latest_numbers
qué cantidad de casos de corona virus hay en canadá	intent:latest_numbers
cuántos niños menores de 15 años han contraído corona virus hasta el momento	intent:latest_numbers
números de enfermeros trajando con pacientes infectados en eeuu	intent:latest_numbers
tasa de crecimiento de infectados con convid-19 en el continente de áfrica	intent:latest_numbers
cuántos respiradores hacen falta para abastecer a todos los pacientes del mundo	intent:latest_numbers
cuántos casos de covid-19 hay en europa del este hasta la fecha de hoy	intent:latest_numbers
me puedes decir si las mascarillas funcionan para proteger del corona virus	intent:protect_yourself
cuáles son los métodos más eficaces para no contagiarse de corona virus	intent:protect_yourself
las mascarillas tienen eficacia para no contagiarse de corona virus	intent:protect_yourself
me informas de qué debo de usar cuando salga a la calle para prevenir un contagio	intent:protect_yourself
cómo se evita contagiarse de covid	intent:protect_yourself
es necesario usar caretas para evitar el contagio	intent:protect_yourself
qué medidas se deben tomar para salir a la calle	intent:protect_yourself
es necesario usar guantes para evitar contagiasre de covid	intent:protect_yourself
cómo proteger a adultos mayores del covid	intent:protect_yourself
qué se debe hacer con las mascotas para evitar contagios de covid	intent:protect_yourself
qué no se debe hacer en esta contingencia de covid	intent:protect_yourself
cómo mantenerme a salvo del covid	intent:protect_yourself
indícame las medidas de seguridad para evitar el contagio de covid-19	intent:protect_yourself
qué puedo hacer para no contagiarme de coronavirus	intent:protect_yourself
qué hacer para no contagiarme	intent:protect_yourself
cómo proteger a mi familia del covid-19	intent:protect_yourself
dime las medidas de prevención para el coronavirus	intent:protect_yourself
medidas de prevención del coronavirus, por favor	intent:protect_yourself
qué tipo de cubrebocas funciona para evitar el contagio de covid-19	intent:protect_yourself
qué hacer para no contagiarme de coronavirus	intent:protect_yourself
sirve usar cubrebocas para protegerme del coronavirus	intent:protect_yourself
cuánto tiempo tengo que lavarme las manos para matar al virus	intent:protect_yourself
qué medidas de protección puedo usar con mis niños	intent:protect_yourself
cuánto cloro tengo que poner al agua para hacer un desinfectante casero	intent:protect_yourself
aconséjame algunas medidas de protección contra el coronavirus	intent:protect_yourself
dime qué medida es más efectiva para protegerme del covid	intent:protect_yourself
sirven las mascarillas para protegerme del coronavirus	intent:protect_yourself
qué es lo más importante para prevenir contagiarme	intent:protect_yourself
en necesario usar mascarillas en espacios abiertos	intent:protect_yourself
sirve si me ducho cada vez que vuelvo del exterior	intent:protect_yourself
es necesario que me lave el pelo también	intent:protect_yourself
qué puedo hacer para evitar que mis abuelos se enfermen	intent:protect_yourself
qué precauciones debor tomar con las frutas y verduras por el covid	intent:protect_yourself
en qué contexto debería ponerme guantes	intent:protect_yourself
es necesario lavar con agua y lavandina todo lo que compro	intent:protect_yourself
el aislamiento es efectivo contra la propagación del virus	intent:protect_yourself
es útil usar guantes cuando salgo de casa	intent:protect_yourself
es útil usar barbijo médico para evitar el contagio de corona virus	intent:protect_yourself
tiene sentido armar mi propio tapaboca para salir de casa a comprar	intent:protect_yourself
qué productos matan al virus	intent:protect_yourself
si pido comida a domicilio, ¿cómo desinfecto lo que me traigan	intent:protect_yourself
qué tapabocas es más efectivo contra el covid	intent:protect_yourself
dime si desinfectar con blanqueador protege del coronavirus	intent:protect_yourself
qué medidas recomiendan para evitar contagiarse de covid	intent:protect_yourself
para no contagiarme de covid debo usar guantes plásticos	intent:protect_yourself
a qué distancia hay que estar para que no te dé covid19	intent:protect_yourself
hay algún tratamiento para el coronavirus	intent:protect_yourself
es importante usar mascarilla	intent:protect_yourself
tomar infusiones calientes evita el ingreso de coronavirus en el organismo	intent:protect_yourself
necesito consejos para protegerme del coronavirus	intent:protect_yourself
qué debo hacer para no enfermarme del coronavirus	intent:protect_yourself
cómo prevenimos el covid 19	intent:protect_yourself
puedo hacer algo para no contagiarme del virus	intent:protect_yourself
no me quiero enfermar del coronavirus, pero no sé qué hacer	intent:protect_yourself
cómo hago para no enfermarme del virus	intent:protect_yourself
trucos para no contagiarse del coronavirus	intent:protect_yourself
cómo debo desinfectar las compras del supermercado	intent:protect_yourself
es efectivo el isopropyl 50% para eliminar el virus de superficies	intent:protect_yourself
puedo usar detergente para vajillas para desinfectar las compras del mercado	intent:protect_yourself
son efectivos los barbijos de tela común para prevenir el contagio	intent:protect_yourself
debo desinfectar la ropa al volver de hacer las compras	intent:protect_yourself
cómo debo proteger a mis mascotas del virus	intent:protect_yourself
las gárgaras de agua caliente y sal funcionan para prevenir el covid-19	intent:protect_yourself
evito el contagio si uso un barbijo	intent:protect_yourself
qué es más efectivo para prevenir el contagio, el barbijo o el tapabocas	intent:protect_yourself
hay algún método para evitar que los adultos mayores se infecten	intent:protect_yourself
cuán efectivo es el aislamiento para no contagiarse	intent:protect_yourself
las máscaras de plástico son efectivas para no contagiarme	intent:protect_yourself
puedes decirme qué es el corona virus	intent:what_is_corona
me gustaría obtener información sobre qué es el corona virus	intent:what_is_corona
quiero saber qué es el corona virus	intent:what_is_corona
me puedes dar algo de información sobre qué es el corona virus	intent:what_is_corona
dime en cuanto puedas lo que es el corona virus	intent:what_is_corona
necesito más información sobre qué es el corona virus	intent:what_is_corona
si pudieras darme información sobre qué es el corona virus te lo voy a agradecer	intent:what_is_corona
dime cuando puedas toda la información pertinente sobre qué es el corona virus	intent:what_is_corona
exactamente qué es el coronavirus	intent:what_is_corona
información del coronavirus	intent:what_is_corona
dime qué es covid 19	intent:what_is_corona
datos del coronavirus	intent:what_is_corona
definición del coronavirus	intent:what_is_corona
tipos de coronavirus	intent:what_is_corona
qué es lo que hay que saber sobre el coronavirus	intent:what_is_corona
quiero saber todo lo relativo al coronavirus	intent:what_is_corona
qué es el coronavirus	intent:what_is_corona
qué significa covid-19	intent:what_is_corona
qué es covid-19	intent:what_is_corona
dame información acerca del coronavirus	intent:what_is_corona
qué tan contagioso es el coronavirus	intent:what_is_corona
quiénes están en riesgo de fallecer por la enfermedad	intent:what_is_corona
quiero saber acerca del coronavirus	intent:what_is_corona
qué es el covid-19	intent:what_is_corona
qué significa covid-19	intent:what_is_corona
explícame qué es el covid-19	intent:what_is_corona
dime cómo se contagia el coronavirus	intent:what_is_corona
de dónde viene el coronavirus	intent:what_is_corona
dame información básica del coronavirus	intent:what_is_corona
explícale a mi hermanito qué es el coronavirus	intent:what_is_corona
qué es exactamente el nuevo corona virus	intent:what_is_corona
explícame exactamente las características del corona virus	intent:what_is_corona
quisiera saber más sobre las características físicas del virus	intent:what_is_corona
quién descubrió el corona virus	intent:what_is_corona
dame más información sobre el proceso de reproducción del corona virus	intent:what_is_corona
covid 19, definición	intent:what_is_corona
me gustaría sabér más acerca del virus	intent:what_is_corona
podrías contarme los datos más importantes sobre el corona virus	intent:what_is_corona
qué me podés contar sobre el virus que está dando vueltas	intent:what_is_corona
me describís qué es el corona virus	intent:what_is_corona
te hago una pregunta, ¿qué es el corona virus	intent:what_is_corona
por qué todos hablan del corona virus? ¿qué es	intent:what_is_corona
necesito entender lo básico de la nueva pandemia	intent:what_is_corona
me aportarías información básica sobre el virus	intent:what_is_corona
explícame qué es el covid19	intent:what_is_corona
origen y estructura del coronavirus	intent:what_is_corona
qué tipo de enfermedad es el coronavirus	intent:what_is_corona
deme datos sobre el virus covid19	intent:what_is_corona
qué características tiene el coronavirus	intent:what_is_corona
documentación sobre coronavirus	intent:what_is_corona
qué características tiene el covid19	intent:what_is_corona
por favor, dime las propiedades del coronavirus	intent:what_is_corona
qué significa covid-19	intent:what_is_corona
quiero saberlo todo sobre el coronavirus	intent:what_is_corona
por qué se lo clasifica como un virus	intent:what_is_corona
quiero ver la estructura molecular del coronavirus	intent:what_is_corona
mostrame una foto de cómo se ve el covid-19 por microscopio	intent:what_is_corona
más información sobre este tema, por favor	intent:what_is_corona
qué es el coronavirs exactamente	intent:what_is_corona
cuáles es la definición de covid 19	intent:what_is_corona
explíqueme lo que es el coronavirus	intent:what_is_corona
no sé qué es coronavirus	intent:what_is_corona
me puedes explicar lo que es el coronavirus	intent:what_is_corona
quiereo aprender sobre el coronavirus	intent:what_is_corona
cómo funciona el corona virus	intent:what_is_corona
cuál es la diferncia entre corona virus y covid-19	intent:what_is_corona
de qué se trata el covid-19	intent:what_is_corona
explícame qué es esta pandemia	intent:what_is_corona
necesito saber qué es el corona virus	intent:what_is_corona
me podrías dar info general sobre el covid-19	intent:what_is_corona
quiero saber más sobre la pandemia del covid-19	intent:what_is_corona
dime todo lo que sepas sobre el virus	intent:what_is_corona
cuéntame lo más importante sobre covid-19	intent:what_is_corona
quisiera saber cuáles son los sintomas del corona virus	intent:what_are_symptoms
crees que pudieras decirme cuáles son los síntomas del corona virus	intent:what_are_symptoms
me es urgente saber cuáles son los síntomas del corona virus	intent:what_are_symptoms
sabes decirme si la falta de aire es un síntoma de corona virus	intent:what_are_symptoms
síntomas del covid	intent:what_are_symptoms
cómo sé si tengo covid	intent:what_are_symptoms
qué características tiene el covid	intent:what_are_symptoms
cuáles son los efectos del covid sobre el cuerpo	intent:what_are_symptoms
cómo identificar el coronavirus	intent:what_are_symptoms
señales para identificar al coronavirus	intent:what_are_symptoms
dime los síntomas si te da covid-19	intent:what_are_symptoms
síntomas del coronavirus	intent:what_are_symptoms
qué debo de sentir si tengo coronavirus	intent:what_are_symptoms
dolor de garganta por coronavirus	intent:what_are_symptoms
cómo empiezan los síntomas del coronavirus	intent:what_are_symptoms
cuáles síntomas provoca el coronavirus	intent:what_are_symptoms
si tengo calentura y dolor de garganta tengo coronavirus	intent:what_are_symptoms
hazme una lista de los síntomas más claros del covid-19	intent:what_are_symptoms
el coronavirus duele	intent:what_are_symptoms
cuál es la sintomatología de alguien contagiado de covid19	intent:what_are_symptoms
además de fiebre, ¿qué otros síntomas provoca el covid	intent:what_are_symptoms
si estuviera contagiado, ¿cuál es el primer síntoma que debo notar	intent:what_are_symptoms
es cierto que el corona virus quita la capacidad de olfato	intent:what_are_symptoms
haz una lista de todos los síntomas identificados hasta ahora	intent:what_are_symptoms
se ha actualizado la información en cuanto a los síntomas del corona virus	intent:what_are_symptoms
cómo es la tos que te da por el corona virus	intent:what_are_symptoms
dime cuándo debería preocuparme y hacerme un examen de covid	intent:what_are_symptoms
se inflaman las amígdalas con covid	intent:what_are_symptoms
me duele la cabeza, ¿tendré corona virus	intent:what_are_symptoms
cuáles son los síntomas más comunes del corona virus	intent:what_are_symptoms
no sentir olores es también un síntoma del virus	intent:what_are_symptoms
cómo me doy cuenta si me enfermé de corona virus? ¿qué sentiría	intent:what_are_symptoms
corona, síntomas, por favor	intent:what_are_symptoms
síntomas del virus ese nuevo, gracias	intent:what_are_symptoms
podrías mostrarme qué se siente cuando tenés corona	intent:what_are_symptoms
la tos con flema es efecto del covid19	intent:what_are_symptoms
qué síntoma del coronavirus es el más común	intent:what_are_symptoms
la diarrea es indicador de covid19	intent:what_are_symptoms
qué malestares da el covid19	intent:what_are_symptoms
cómo se manifiesta el coronavirus en el cuerpo	intent:what_are_symptoms
qué consecuencias físicas genera el coronavirus	intent:what_are_symptoms
cómo afecta la salud el covid19	intent:what_are_symptoms
listado de síntomas del coronavirus	intent:what_are_symptoms
qué me duela la cabeza es síntoma del covid-19	intent:what_are_symptoms
cómo se evidencia el coronavirus en los pacientes	intent:what_are_symptoms
cansancio extremo puede ser un indicio de coronavirus	intent:what_are_symptoms
qué experimentaría si me infectara de covid-19	intent:what_are_symptoms
enumerame los indicios que hay que tener en cuenta para el covid-19	intent:what_are_symptoms
qué cosas sí son síntoma de coronavirus	intent:what_are_symptoms
cómo estar segura de si tengo coronavirus o no	intent:what_are_symptoms
cuál es el síntoma principal del covid 19	intent:what_are_symptoms
la diarrea es síntoma del coronavirus	intent:what_are_symptoms
qué síntomas tiene alguien con covid 19	intent:what_are_symptoms
este es un síntoma del virus	intent:what_are_symptoms
cómo hago para saber si tengo covid 19	intent:what_are_symptoms
si me duele la garganta, ¿significa que tengo corona virus	intent:what_are_symptoms
cuáles son los signos del corona virus	intent:what_are_symptoms
qué síntomas tiene una persona que ha contraído el corona virus	intent:what_are_symptoms
el dolor de cuerpo es un síntoma	intent:what_are_symptoms
cómo puedo autodiagnosticarme	intent:what_are_symptoms
qué debo hacer para saber si me he contagiado con covid-19	intent:what_are_symptoms
dame información sobre los síntomas del virus	intent:what_are_symptoms
cuáles son los síntomas menos comunes de esta pandemia	intent:what_are_symptoms
puede ser la congestión nasal síntoma del virus	intent:what_are_symptoms
debo preocuparme por el corona virus si tengo ataques de estornudo	intent:what_are_symptoms
cuál es la fiebre promedio de una persona con covid-19	intent:what_are_symptoms
puedes decirme los métodos de contagio del corona virus	intent:how_does_corona_spread
necesito saber cuáles son los principales medios de contagio del corona virus	intent:how_does_corona_spread
quiero que me digas ya cómo se contagia el corona virus	intent:how_does_corona_spread
tengo mucha necesidad de conocer los medios de contagio del corona virus	intent:how_does_corona_spread
sabes si el corona virus se contagia por medio de los abrazos	intent:how_does_corona_spread
me sabes decir si el corona virus se contagia por medio de los estornudos	intent:how_does_corona_spread
cómo se infecta uno de coronavirus	intent:how_does_corona_spread
la comida puede ser un factor de contagio de covid	intent:how_does_corona_spread
mecanismos de propagación del virus	intent:how_does_corona_spread
ambientes que facilitan el contagio de covid	intent:how_does_corona_spread
transmisión del coronavirus	intent:how_does_corona_spread
modos de contagirse de covid	intent:how_does_corona_spread
principales ambientes contaminantes de covid	intent:how_does_corona_spread
cómo se puede contagiar uno de coronavirus	intent:how_does_corona_spread
cómo contraigo la enfermedad en la calle	intent:how_does_corona_spread
el virus se queda en el aire	intent:how_does_corona_spread
por qué medios se transmite el coronavirus	intent:how_does_corona_spread
cómo se propaga el virus	intent:how_does_corona_spread
información de cómo se contagia el coronavirus	intent:how_does_corona_spread
cuál es la principal forma de contagio del coronavirus	intent:how_does_corona_spread
me puedo contagiar de covid si toco a alguien enfermo	intent:how_does_corona_spread
los principales medios de contagio del covid	intent:how_does_corona_spread
el coronavirus viaja en los zapatos	intent:how_does_corona_spread
me puedo contagiar de coronavirus si la enfermera me roza	intent:how_does_corona_spread
es posible contagiarse si respiramos el mismo aire	intent:how_does_corona_spread
si me quedo en mi casa ya no me contagio de coronavirus	intent:how_does_corona_spread
qué debo de evitar tocar para no contagiarme de covid19	intent:how_does_corona_spread
me puedo contagiar corona virus por tocarme el pelo	intent:how_does_corona_spread
cúanto rato queda volando en el aire el virus	intent:how_does_corona_spread
no me queda claro la distancia que puede recorrer el virus en el aire	intent:how_does_corona_spread
quiero saber si el virus se transmite a través de fluidos corporales	intent:how_does_corona_spread
cuál es la probabilidad que el virus esté en las veredas	intent:how_does_corona_spread
puedo contagiarme del virus a través de billetes y monedas	intent:how_does_corona_spread
el corona virus se transmite por la saliva	intent:how_does_corona_spread
puedo contagiarme corona virus por hacer gimnasia en el mismo lugar que otros	intent:how_does_corona_spread
el sudor transmite corona virus	intent:how_does_corona_spread
puedo contagiarme de corona virus al mantener sexo con alguien infectado	intent:how_does_corona_spread
me gustaría saber cómo se transmite el virus	intent:how_does_corona_spread
en qué lugares puedo contagiarme el corona virus	intent:how_does_corona_spread
dicen que es muy contagioso el virus nuevo, ¿cómo se contagia	intent:how_does_corona_spread
no entiendo qué contagia corona virus, ¿me contás	intent:how_does_corona_spread
cómo se transmite de persona a persona el corona virus	intent:how_does_corona_spread
el corona virus se transmite por vectores	intent:how_does_corona_spread
dé qué formas se pega el coronavirus	intent:how_does_corona_spread
en clima caliente hay menos transmisión de covid19	intent:how_does_corona_spread
el covid19 se transmite por tocar la ropa	intent:how_does_corona_spread
en qué materiales se transmite el coronavirus	intent:how_does_corona_spread
cómo se pasa el coronavirus de una persona a otra	intent:how_does_corona_spread
en los colegios se contagian más de covid19	intent:how_does_corona_spread
el coronavirus se transmite en frutas y verduras	intent:how_does_corona_spread
formas en que se expande el coronavirus	intent:how_does_corona_spread
formas de contagiarse coronavirus	intent:how_does_corona_spread
el coronavirus se transmite sexualmente	intent:how_does_corona_spread
es contagioso compartir el mate con un contagiado	intent:how_does_corona_spread
qué tan contagioso es el coronavirus	intent:how_does_corona_spread
el coronavirus se contagia por aire	intent:how_does_corona_spread
me puedo contagiar por abrazar sin protección a un infectado	intent:how_does_corona_spread
una persona se puede contagiar por segunda vez	intent:how_does_corona_spread
cuál es la forma más común de contagiarse	intent:how_does_corona_spread
cuál es la ruta de contagio del virus	intent:how_does_corona_spread
medios por los que uno se contagia del coronavirus	intent:how_does_corona_spread
dígame como se contagia uno del corona virus	intent:how_does_corona_spread
el covid 19 se contagia por la comida	intent:how_does_corona_spread
cómo da el corona virus	intent:how_does_corona_spread
explícame cómo funciona el contagio del virus	intent:how_does_corona_spread
puedo contagiarme con corona virus si ingiero un alimento contaminado	intent:how_does_corona_spread
cuál es la forma más común de contagio	intent:how_does_corona_spread
puedes explicarme la forma de propagación de este virus	intent:how_does_corona_spread
de qué forma puedo contraer covid-19	intent:how_does_corona_spread
dame info sobre la forma de contracción del virus	intent:how_does_corona_spread
se puede contraer este virus si se comparten calzados	intent:how_does_corona_spread
sabes si puedo contagiarme de corona virus comiendo carne de cerdo	intent:can_i_get_from_feces_animal_pets
quiero saber si mi perro me puede contagiar de corona virus	intent:can_i_get_from_feces_animal_pets
puedes decirme si el corona virus se puede contagiar mediante animales	intent:can_i_get_from_feces_animal_pets
me hace falta que me digas si al comer carne de ternera me puedo contagiar de corona virus	intent:can_i_get_from_feces_animal_pets
las mascotas se pueden contagiar de covid	intent:can_i_get_from_feces_animal_pets
puedo infectarme de covid por comer carne de pollo	intent:can_i_get_from_feces_animal_pets
las mascotas pueden contagiar a las personas de covid	intent:can_i_get_from_feces_animal_pets
los zancudos transmiten covid	intent:can_i_get_from_feces_animal_pets
la saliva de los animales puede contagiar de covid	intent:can_i_get_from_feces_animal_pets
qué tipo de carne contagia el virus	intent:can_i_get_from_feces_animal_pets
qué animales nos pueden contagiar	intent:can_i_get_from_feces_animal_pets
le puede dar covid-19 a mi mascota	intent:can_i_get_from_feces_animal_pets
el coronavirus se transmite por contacto con animales	intent:can_i_get_from_feces_animal_pets
los animales se contagian de coronavirus	intent:can_i_get_from_feces_animal_pets
nos podemos contagiar por animales	intent:can_i_get_from_feces_animal_pets
mi perro se puede contagiar de covid	intent:can_i_get_from_feces_animal_pets
es posible que mi gatos se enferme de coronavirus	intent:can_i_get_from_feces_animal_pets
si como carne de animales salvajes me contagiaré de coronavirus	intent:can_i_get_from_feces_animal_pets
los pájaros se contagian de coronavirus	intent:can_i_get_from_feces_animal_pets
la carne de puerco puede transmitir el covid	intent:can_i_get_from_feces_animal_pets
los animales de granja también se pueden contagiar de covid	intent:can_i_get_from_feces_animal_pets
el coronavirus ataca a los animales domésticos	intent:can_i_get_from_feces_animal_pets
las ratas, ¿se contagian de covid19	intent:can_i_get_from_feces_animal_pets
dime si es riesgoso comer pescado crudo	intent:can_i_get_from_feces_animal_pets
me puedo contagiar corona virus a través de las vacas	intent:can_i_get_from_feces_animal_pets
han muerto animales del zoológico por corona virus	intent:can_i_get_from_feces_animal_pets
por qué gatos y perros no se contagian	intent:can_i_get_from_feces_animal_pets
no entiendo por qué se han contagiado animales, explícame	intent:can_i_get_from_feces_animal_pets
tengo un hamster, ¿podría contagiarse de corona virus	intent:can_i_get_from_feces_animal_pets
los gatos domésticos pueden contagiarse de corona virus	intent:can_i_get_from_feces_animal_pets
qué animales transmiten el corona virus a los humanos	intent:can_i_get_from_feces_animal_pets
puedo sacar a pasear a mi perro? tengo miedo de que se contagie del virus	intent:can_i_get_from_feces_animal_pets
es posible que contagie a mis mascotas del virus	intent:can_i_get_from_feces_animal_pets
los animales pueden contagiarme del corona virus	intent:can_i_get_from_feces_animal_pets
me das una lista de animales que transmiten el covid a los humanos	intent:can_i_get_from_feces_animal_pets
mi loro puede enfermarse de corona	intent:can_i_get_from_feces_animal_pets
a qué animales les puede dar coronavirus	intent:can_i_get_from_feces_animal_pets
el coronavirus de los animales es el mismo de los humanos	intent:can_i_get_from_feces_animal_pets
a mi gata se le puede pegar el coronavirus	intent:can_i_get_from_feces_animal_pets
qué animales pueden sufrir el coronavirus	intent:can_i_get_from_feces_animal_pets
tipos de carne que dan coronavirus	intent:can_i_get_from_feces_animal_pets
las mascotas pueden ser transmisoras de coronavirus	intent:can_i_get_from_feces_animal_pets
el pescado puede tener covid-19	intent:can_i_get_from_feces_animal_pets
hay animales infectados de coronavirus	intent:can_i_get_from_feces_animal_pets
si mi perro huele a otro perro, ¿se puede contagiar covid-19	intent:can_i_get_from_feces_animal_pets
cómo puedo saber si mi mascota se contagió covid-19	intent:can_i_get_from_feces_animal_pets
por qué los animales son inmunes al coronavirus	intent:can_i_get_from_feces_animal_pets
es seguro que los animales no pueden propagar el virus	intent:can_i_get_from_feces_animal_pets
los pollos pueden ser portadores de covid 19	intent:can_i_get_from_feces_animal_pets
tengo miedo que mi gato se enferme del coronavirus. ¿es posible	intent:can_i_get_from_feces_animal_pets
las mascotas se enferman del covid 19 también	intent:can_i_get_from_feces_animal_pets
es sano comer pollo durante la pandemia	intent:can_i_get_from_feces_animal_pets
me puedo enfermar de corona virus por el pescado	intent:can_i_get_from_feces_animal_pets
los perros son inmunes al coronavirus	intent:can_i_get_from_feces_animal_pets
es posible que de coronavirus por comer carne	intent:can_i_get_from_feces_animal_pets
es posible contagiarse el virus consumiendo pollo	intent:can_i_get_from_feces_animal_pets
qué animales pueden contraer covid-19	intent:can_i_get_from_feces_animal_pets
mis gatos pueden agarrarse el virus	intent:can_i_get_from_feces_animal_pets
es seguro comer pescado en relación al corona virus	intent:can_i_get_from_feces_animal_pets
el contagio es posible a través de ratas	intent:can_i_get_from_feces_animal_pets
qué animales de granja pueden contraer este virus	intent:can_i_get_from_feces_animal_pets
necesito información sobre la propagación de corona virus en perreras	intent:can_i_get_from_feces_animal_pets
sabes si los paquetes de mensajería pueden contagiarme de corona virus	intent:can_i_get_from_packages_surfaces
me puedes decir cuánto tiempo está el corona virus en el plástico	intent:can_i_get_from_packages_surfaces
si puedes dime cuánto dura el corona virus activo en paquetes de cartón, por favor	intent:can_i_get_from_packages_surfaces
quisiera saber cuánto tiempo sobrevive el corona virus en el plástico, por favor	intent:can_i_get_from_packages_surfaces
tienes algo de información de cuánto tiempo dura el corona virus en el papel	intent:can_i_get_from_packages_surfaces
cuanto tiempo sobrevevive el corona virus en las superficies	intent:can_i_get_from_packages_surfaces
necesito saber el tiempo que vive el corona virus en las superficies	intent:can_i_get_from_packages_surfaces
se puede uno infectar de covid por el aire	intent:can_i_get_from_packages_surfaces
en qué superficies vive el covid	intent:can_i_get_from_packages_surfaces
el agua puede estar contaminada con covid	intent:can_i_get_from_packages_surfaces
se adhiere el covid al cabello	intent:can_i_get_from_packages_surfaces
el coronavirus puede estar en los celualres	intent:can_i_get_from_packages_surfaces
puede el coronavirus viajar en el aire	intent:can_i_get_from_packages_surfaces
en cuánto tiempo se muere el coronavirus	intent:can_i_get_from_packages_surfaces
en qué superficies sobrevive más tiempo el coronavirus	intent:can_i_get_from_packages_surfaces
hasta cuántos días puede estar el virus en una superficie	intent:can_i_get_from_packages_surfaces
puedo contraer el virus por tocar cosas	intent:can_i_get_from_packages_surfaces
el coronavirus sobrevive en el plástico	intent:can_i_get_from_packages_surfaces
cuánto tiempo vive el coronavirus sobre una superficie	intent:can_i_get_from_packages_surfaces
duración del virus sobre superficies	intent:can_i_get_from_packages_surfaces
tiempo de vida del covid-19 si se queda sobre una superficie	intent:can_i_get_from_packages_surfaces
el virus permanece vivo en las superficies	intent:can_i_get_from_packages_surfaces
si recibo un paquete de amazon puede que tenga coronavirus	intent:can_i_get_from_packages_surfaces
cómo limpio mi celular para evitar que tenga el coronavirus	intent:can_i_get_from_packages_surfaces
el coronavirus puede quedarse en la pantalla de mi celular	intent:can_i_get_from_packages_surfaces
cuánto tiempo vive el virus en el metal	intent:can_i_get_from_packages_surfaces
el covid puede subsistir en mi vehículo	intent:can_i_get_from_packages_surfaces
el virus puede vivir en los vidrios de mi coche	intent:can_i_get_from_packages_surfaces
en qué superficies no sobrevive el coronavirus	intent:can_i_get_from_packages_surfaces
dime las superficies en las que el virus puede sobrevivir más tiempo	intent:can_i_get_from_packages_surfaces
cuánto tiempo puede estar el virus en las frutas y verduras	intent:can_i_get_from_packages_surfaces
el cobre repele el corona virus	intent:can_i_get_from_packages_surfaces
el virus está en la superficie de los árboles	intent:can_i_get_from_packages_surfaces
es mejor si compro ensaladas en bolsas plásticas	intent:can_i_get_from_packages_surfaces
el jabón mata el virus en cualquier superficie	intent:can_i_get_from_packages_surfaces
cuántas horas vive el virus en los empaques de plástico	intent:can_i_get_from_packages_surfaces
puede el virus sobrevivir en empaques de papel	intent:can_i_get_from_packages_surfaces
el virus vive en los tejidos de punto, ¿es así	intent:can_i_get_from_packages_surfaces
necesito información sobre la sobrevida del virus en superficies horizontales	intent:can_i_get_from_packages_surfaces
me gustaría saber cuántas horas vive el virus en el papel de mis libros	intent:can_i_get_from_packages_surfaces
quiero saber si el virus puede vivir en la ropa que uso	intent:can_i_get_from_packages_surfaces
cuánto tiempo dura el virus en la superficie de los productos que compro	intent:can_i_get_from_packages_surfaces
cuántas horas resiste el covid19 en el cartón	intent:can_i_get_from_packages_surfaces
información de covid19 en metales	intent:can_i_get_from_packages_surfaces
hay que desinfectar la madera de covid19	intent:can_i_get_from_packages_surfaces
el covid19 puede reproducirse en una superficie	intent:can_i_get_from_packages_surfaces
duración del coronavirus en el vidrio	intent:can_i_get_from_packages_surfaces
si recibo domicilios en cajas me puedo infectar de covid19	intent:can_i_get_from_packages_surfaces
materiales en los que dura más el coronavirus	intent:can_i_get_from_packages_surfaces
cuál es la superficie sobre la que más tiempo sobrevive el virus	intent:can_i_get_from_packages_surfaces
el virus se queda más impregnado en superficies porosas	intent:can_i_get_from_packages_surfaces
cuántas horas sobrevive el virus esparcido en las superficies	intent:can_i_get_from_packages_surfaces
el virus sobrevive si cae en superficies oxidadas	intent:can_i_get_from_packages_surfaces
si me llega un paquete de un domicilio infectado, ¿es seguro abrirlo	intent:can_i_get_from_packages_surfaces
cómo se deben higienizar las superficies para eliminar el virus	intent:can_i_get_from_packages_surfaces
el uso de guantes reduce la posibilidad de contagio por contacto a través de superficies	intent:can_i_get_from_packages_surfaces
de qué manera el virus queda impregnado en las superficies	intent:can_i_get_from_packages_surfaces
me puedo contagiar por tocar los paquetes del supermercado	intent:can_i_get_from_packages_surfaces
cuánto tiempo vive el virus sobre el metal	intent:can_i_get_from_packages_surfaces
me puedo contagiar del coronavirus por tocar una superficie	intent:can_i_get_from_packages_surfaces
es peligroso tocar el dinero efectivo por el coronavirus	intent:can_i_get_from_packages_surfaces
si el virus está sobre mi bolsa, ¿me puedo enfermar	intent:can_i_get_from_packages_surfaces
las superficies son contagiosas de covid 19	intent:can_i_get_from_packages_surfaces
me puedo contagiar por tocar el teclado de mi computador	intent:can_i_get_from_packages_surfaces
cuánto dura el virus vivo sobre el vidrio	intent:can_i_get_from_packages_surfaces
cuál es el tipo de superficie donde más tiempo puede vivir el virus	intent:can_i_get_from_packages_surfaces
en cuánto tiempo muere el virus en superficies de papel	intent:can_i_get_from_packages_surfaces
cuánto vive el virus en superficies de madera	intent:can_i_get_from_packages_surfaces
es el metal la superficie donde el virus sobrevive más tiempo	intent:can_i_get_from_packages_surfaces
puede vivir el virus en superficies como el polietileno	intent:can_i_get_from_packages_surfaces
preciso saber si el virus se propaga por superficies de cristal	intent:can_i_get_from_packages_surfaces
necesito que me digas cuáles son los países con más riesgos de corona virus	intent:what_if_i_visited_high_risk_area
qué debo de hacer si recientemente he visitado italia y está en alerta por corona virus	intent:what_if_i_visited_high_risk_area
necesitaría información sobre qué debo hacer si he ido a china hace poco	intent:what_if_i_visited_high_risk_area
me dices cuáles son los países con más riesgo de corona virus	intent:what_if_i_visited_high_risk_area
me hace mucha falta saber cuáles son los países con máxima alerta por corona virus	intent:what_if_i_visited_high_risk_area
si he visitado una zona de alto riesgo por corona virus, ¿qué debo hacer ahora	intent:what_if_i_visited_high_risk_area
qué debo hacer si tengo que ir a un hospital	intent:what_if_i_visited_high_risk_area
qué hacer si acabo de regresar de un viaje a china	intent:what_if_i_visited_high_risk_area
cuáles son las zonas de riesgo en méxico por covid	intent:what_if_i_visited_high_risk_area
cómo identificar una zona de riesgo	intent:what_if_i_visited_high_risk_area
cómo protegerme de covid si debor ir a una zona riesgosa	intent:what_if_i_visited_high_risk_area
cómo cuidarme en una situación de riesgo de contagio de covid	intent:what_if_i_visited_high_risk_area
reglas para evitar el contagio de covid	intent:what_if_i_visited_high_risk_area
qué países son zona de riesgo del coronavirus	intent:what_if_i_visited_high_risk_area
qué pasa si estuve en una zona de contagio	intent:what_if_i_visited_high_risk_area
qué hago si salí de viaje	intent:what_if_i_visited_high_risk_area
me pude haber contagiado si estuve en europa hace unos meses	intent:what_if_i_visited_high_risk_area
países en estado de alerta por covid-19	intent:what_if_i_visited_high_risk_area
cómo sé si estuve en zonas de alto riesgo	intent:what_if_i_visited_high_risk_area
indícame las zonas de alto riesgo en méxico	intent:what_if_i_visited_high_risk_area
al día de hoy, ¿cuáles países son de alto riesgo por covid	intent:what_if_i_visited_high_risk_area
voy a hacer un viaje a españa, ¿cómo me cuido	intent:what_if_i_visited_high_risk_area
en dónde puedo comprar insumos para protegerme del virus	intent:what_if_i_visited_high_risk_area
dime los estados de méxico en donde se activó la fase 3 de contagio	intent:what_if_i_visited_high_risk_area
cuál es el protocolo para los ciudadanos cuando se activa la fase 3	intent:what_if_i_visited_high_risk_area
dime los países de europa que están en periodo de contagio	intent:what_if_i_visited_high_risk_area
cuáles son las recomendaciones para cuidar a una persona enferma	intent:what_if_i_visited_high_risk_area
menciona las formas en las que puedo protegerme al salir al súper	intent:what_if_i_visited_high_risk_area
qué medidas de precaución debo hacer si asisto a lugares públicos	intent:what_if_i_visited_high_risk_area
a dónde debo llamar si creo que puedo estar contagiado	intent:what_if_i_visited_high_risk_area
qué pasa si vengo de nueva york, qué debería hacer	intent:what_if_i_visited_high_risk_area
a qué países no es posible viajar	intent:what_if_i_visited_high_risk_area
cuál es el protocolo de viajes dentro de chile	intent:what_if_i_visited_high_risk_area
cuéntame sobre los protocolos que aplica alemania en sus aeropuertos	intent:what_if_i_visited_high_risk_area
medidas a tomar si vengo de estados unidos	intent:what_if_i_visited_high_risk_area
quiero saber si están dejando entrar a cuba por el tema del virus	intent:what_if_i_visited_high_risk_area
hay un protocolo para viajar a españa	intent:what_if_i_visited_high_risk_area
qué medidas se toman dentro de los aviones para prevenir el contagio	intent:what_if_i_visited_high_risk_area
qué tengo que hacer si mi compañero de trabajo volvió de nueva york hace poco	intent:what_if_i_visited_high_risk_area
qué protocolo debo seguir si estuve en una zona de riesgo de corona virus	intent:what_if_i_visited_high_risk_area
cuáles son los países considerados zona de riesgo en la actualidad	intent:what_if_i_visited_high_risk_area
cómo hago para viajar a un país considerado zona de riesgo de corona virus	intent:what_if_i_visited_high_risk_area
existe un protocolo para los viajeros que llegan al país de lugares en riesgo	intent:what_if_i_visited_high_risk_area
me gustaría tener información sobre las zonas de alto riesgo de corona virus	intent:what_if_i_visited_high_risk_area
qué debo hacer cuando vuelva a mi país desde brasil	intent:what_if_i_visited_high_risk_area
qué hacer si creo que tengo covid19 por viajar a italia	intent:what_if_i_visited_high_risk_area
cómo se cuida la gente de wuhan	intent:what_if_i_visited_high_risk_area
protocolo de atención a personas que vienen de china	intent:what_if_i_visited_high_risk_area
indicaciones para italianos con covid19	intent:what_if_i_visited_high_risk_area
cómo actuar si estoy en una región de alto riesgo de contagio	intent:what_if_i_visited_high_risk_area
cómo evito contagiar a otros si vengo de china	intent:what_if_i_visited_high_risk_area
qué precauciones debo tomar si volví recientemente de un país de alto riesgo	intent:what_if_i_visited_high_risk_area
cuáles son los países que mi país considera de alto riesgo	intent:what_if_i_visited_high_risk_area
cómo me debo comportar si volví de alemania esta semana	intent:what_if_i_visited_high_risk_area
es seguro viajar a un país considerado de alto riesgo	intent:what_if_i_visited_high_risk_area
debo usar alguna vestimenta en especial para viajar a un país de alto riesgo	intent:what_if_i_visited_high_risk_area
qué áreas hay que evitar para no contagiarse	intent:what_if_i_visited_high_risk_area
viajo a casa de italia, dígame qué tengo que hacer ahora	intent:what_if_i_visited_high_risk_area
en dónde está peor el virus ahora	intent:what_if_i_visited_high_risk_area
qué hago si acabo de volver de una zona de alto riesgo de covid	intent:what_if_i_visited_high_risk_area
cuál es el protocolo ahora que volví de la zona de algo riesgo	intent:what_if_i_visited_high_risk_area
dime los pasos a seguir después de visitar nueva york	intent:what_if_i_visited_high_risk_area
qué hace uno después de un viaje a china, en caso de contagio de coronavirus	intent:what_if_i_visited_high_risk_area
qué pasos debo seguir si he estado en contacto con gente con alta probabilidad de estar contaminada con el virus	intent:what_if_i_visited_high_risk_area
estuve en un geriátrico donde hay muchos casos de covid-19. ¿qué hago	intent:what_if_i_visited_high_risk_area
qué cosas debo tener en cuenta si uso transporte público en manhattan	intent:what_if_i_visited_high_risk_area
cómo procedo si estuve en españa	intent:what_if_i_visited_high_risk_area
hace poco volví de europa ¿qué protocolo debo seguir	intent:what_if_i_visited_high_risk_area
sabes si ya hay cura para el corona virus	intent:what_are_treatment_options
puedes decirme cuáles son los tratamientos para el corona virus	intent:what_are_treatment_options
necesito toda la información que tengas sobre si hay ya una cura para el corona virus	intent:what_are_treatment_options
podrías decirme cuál es el tratamiento para el corona virus	intent:what_are_treatment_options
cuáles son los tratamientos para el corona virus	intent:what_are_treatment_options
quiero saber todas las opciones de tratamiento para el corona virus	intent:what_are_treatment_options
dime, por favor, cuáles son los medicamentos para tratar el corona virus	intent:what_are_treatment_options
tratamientos más usados y efectivos contra el corona virus, por favor	intent:what_are_treatment_options
tratamiento preventivo covid	intent:what_are_treatment_options
pueden curarse los infectados de covid	intent:what_are_treatment_options
la vitamina c ayuda para no infectarse de covid	intent:what_are_treatment_options
qué medicina se usa para tratar a infectados con covid	intent:what_are_treatment_options
vacunas contra covid	intent:what_are_treatment_options
sirven los antibióticos contra el covid	intent:what_are_treatment_options
ya hay cura para el coronavirus	intent:what_are_treatment_options
ya existe una vacuna para el coronavirus	intent:what_are_treatment_options
tratamientos disponibles del covid-19	intent:what_are_treatment_options
métodos para tratar el coronavirus	intent:what_are_treatment_options
cuál es el tratamiento que le dan a los pacientes de covid-19	intent:what_are_treatment_options
tratamiento más efectivo para curar el coronavirus	intent:what_are_treatment_options
ya hay una vacuna contra el covid-19	intent:what_are_treatment_options
cuál es el tratamiento para curar el coronavirus	intent:what_are_treatment_options
sabes si ya tienen una vacuna para el covid	intent:what_are_treatment_options
hay algún tratamiento para combatir el covid-19	intent:what_are_treatment_options
los medicamentos contra la gripe son buenos para matar el coronavirus	intent:what_are_treatment_options
qué medicinas son efectivas para tratar a los pacientes de covid	intent:what_are_treatment_options
cualquier retroviral me puede ayudar para combatir el contagio	intent:what_are_treatment_options
sabes si las farmacéuticas ya tienen la cura para el coronavirus	intent:what_are_treatment_options
qué opciones de tratamiento existen para el covid-19	intent:what_are_treatment_options
puedo tratar el corona virus sólo con paracetamol	intent:what_are_treatment_options
de qué se trata el tratamiento con plasma para el coronavirus	intent:what_are_treatment_options
cuál es el tratamiento más eficaz para tratar este virus	intent:what_are_treatment_options
quiero saber para cuándo se estima que esté lista una vacuna para el covid	intent:what_are_treatment_options
es posible sanarse completamente de covid	intent:what_are_treatment_options
puedo tomar antibióticos si me enfermo de corona virus	intent:what_are_treatment_options
ya existe la vacuna contra el corona virus	intent:what_are_treatment_options
leí por ahí que estaban probando con antiretrovirales, ¿son eficaces contra el virus nuevo	intent:what_are_treatment_options
es cierto que si tomo vitamina c puedo curarme del virus	intent:what_are_treatment_options
hay algún tratamiento natural contra el virus	intent:what_are_treatment_options
me gustaría conocer las opciones que tengo para curarme del corona virus	intent:what_are_treatment_options
podrías listar los medicamentos que se utilizan contra el corona virus	intent:what_are_treatment_options
qué medicación se utiliza para tratar pacientes con corona virus	intent:what_are_treatment_options
para cuándo estará la vacuna contra el covid19	intent:what_are_treatment_options
qué países están investigando la cura del coronavirus	intent:what_are_treatment_options
cuán cerca estamos de tener vacuna contra coronavirus	intent:what_are_treatment_options
tratamientos contra covid19 que se están haciendo en el mundo	intent:what_are_treatment_options
fármacos que sirven como tratamiento para el coronavirus	intent:what_are_treatment_options
medicamentos que curan el coronavirus	intent:what_are_treatment_options
eficacia de la enzima de papaya para curar el coronavirus	intent:what_are_treatment_options
cuál es el medicamento adecuado para tratar el covid-19	intent:what_are_treatment_options
es verdad que puede tardar años la vacuna contra el coronavirus	intent:what_are_treatment_options
hay algún remedio casero que ayude a sobrellevar la enfermedad	intent:what_are_treatment_options
es aconsejable el uso de ibuprofenos	intent:what_are_treatment_options
qué tipo de tratamientos se dispone actualmente contra el coronavirus	intent:what_are_treatment_options
qué le receta el médico a los pacientes infectados	intent:what_are_treatment_options
quiero conocer los medicamentos usados hasta el momento contra el covid-19	intent:what_are_treatment_options
las infusiones calientes son parte del tratamiento contra el coronavirus	intent:what_are_treatment_options
será que ya venden la cura del coronavirus	intent:what_are_treatment_options
dime si ya existe la vacuna contra el covid 19	intent:what_are_treatment_options
dígame el tratamiento que se hace ahora contra el virus	intent:what_are_treatment_options
cuál es el tratamiento estándar contra el corona virus	intent:what_are_treatment_options
hay alguna droga que cura el corona virus	intent:what_are_treatment_options
es posible curar el covid 19	intent:what_are_treatment_options
cómo se puede tratar el coronavirus en este momento	intent:what_are_treatment_options
la lavanda sirve para curar el corona virus	intent:what_are_treatment_options
qué opciones tengo para sobrellevar el corona virus	intent:what_are_treatment_options
sabes si hay tratamientos disponibles contra el corona virus	intent:what_are_treatment_options
los complejos vitamínicos ayudan a aliviar los síntomas del virus	intent:what_are_treatment_options
cuándo van a sacar la vacuna contra el corona virus	intent:what_are_treatment_options
qué debo hacer para mitigar los síntomas del virus	intent:what_are_treatment_options
quisiera saber todos los mitos sobre el corona virus	intent:myths
dime todos los mitos sobre el corona virus en cuanto puedas	intent:myths
mitos relacionados con el corona virus, por favor	intent:myths
quiero saber todos los mitos ya desmentidos relacionados con el corona virus	intent:myths
me urge saber cuáles son los mitos sobre el corona virus	intent:myths
podrías decirme algunos de los mitos sobre el corona virus	intent:myths
quiero saber toda la información que tengas sobre los mitos del corona virus	intent:myths
es realmente un mito que el corona virus apenas afecta a los menores de edad	intent:myths
tienes conocimento de si es un mito que el corona virus solo afecta a los ancianos	intent:myths
cuáles son los mitos comunes sobre covid	intent:myths
es cierto que el agua coloidal cura el covid o es un mito	intent:myths
dime qué mitos hay sobre el coronavirus	intent:myths
es mito o realidad que el covid es como una influenza	intent:myths
qué tratamientos para el covid son un mito	intent:myths
cómo saber si los tratamientos para el covid son un mito	intent:myths
lista de mitos sobre covid	intent:myths
lo de que el ajo cura el covid es un mito	intent:myths
realidades y mitos del coronavirus	intent:myths
es verdad que el sol mata el virus	intent:myths
el café mata el coronavirus	intent:myths
es cierto que solamente le da coronavirus a los adultos mayores	intent:myths
cuál es la información falsa acerca del coronavirus	intent:myths
es cierto que las gárgaras te quitan el coronavirus	intent:myths
mitos y verdades del coronavirus	intent:myths
creencias sobre el origen del coronavirus	intent:myths
con el clima caluroso se muere el virus	intent:myths
el coronavirus solo le da a los ricos	intent:myths
solo las personas mayores pueden contagiarse del covid-19	intent:myths
si como carne de murciélago puedo desarrollar anticuerpos naturales para el coronavirus	intent:myths
los piquetes de mosquito pueden contagiarme de coronavirus	intent:myths
el coronavirus es una gripe más fuerte	intent:myths
es cierto que los niños no mueren de corona virus	intent:myths
es verdad que uno se puede volver a contagiar de covid19	intent:myths
se comprobó el mito de que tomar agua previene el covid	intent:myths
es verdad o mentira que ningún animal se contagia de corona virus	intent:myths
dame una lista de los mitos verificados sobre el corona virus	intent:myths
dime si es verdad que tomar vitamina c previene el coronavirus	intent:myths
es cierto o un mito que el origen del virus es un murciélago	intent:myths
es cierto o un mito que el virus no existe	intent:myths
mostrame un listado de mitos en torno del corona virus	intent:myths
qué mitos hay sobre el virus	intent:myths
es mito que puedo matar al virus con un secador de pelo	intent:myths
es un mito que los perros transmiten el covid19	intent:myths
qué ideas falsas tiene la gente sobre el coronavirus	intent:myths
mitos de orígenes del coronavirus	intent:myths
hay un mito de que las salas de emergencia de covid19 están vacías	intent:myths
cuéntame el mito de que el virus se creó en un laboratorio	intent:myths
lo de tener que usar tapabocas es mito	intent:myths
quiero conocer los mitos más extendidos sobre el covid-19	intent:myths
es verdad que la cocaína inhibe los efectos del virus	intent:myths
cuáles son los cinco mitos más famosos sobre el coronavirus	intent:myths
es verdad o mito que la pandemia responde a intereses políticos internacionales	intent:myths
es verdad que se miente con los números y la estadísticas	intent:myths
si te ponés dos barbijos, ¿estás más proptegido	intent:myths
es verdad que los niños son inmunes al coronavirus	intent:myths
es verdad que el coronavirus no afecta a los jóvenes	intent:myths
dime los mitos más frecuentes sobre el covid 19	intent:myths
qué mitos andan por ahí sobre la enfermedad que no sean ciertos	intent:myths
es cierto que los gatos se pueden enfermar, o es mito	intent:myths
mitos sobre el covid 19, por favor	intent:myths
hay información falsa sobre el corona virus	intent:myths
cuál es el mito más común acerca del virus	intent:myths
me podrías dar más información sobre los mitos del covid-19	intent:myths
es verdad que el corona virus no afecta a los niños	intent:myths
puedes decirme si es un mito que el corona virus es más peligroso para la gente con asma	intent:myths
sabes si es un mito que el corona virus no afecta a la gente que ya tuvo corona virus	intent:myths
dime si la esterilidad es un mito sobre el corona virus	intent:myths
es falsa la idea de que el corona virus puede afectar la visión	intent:myths
quiero saber si hay nuevos mitos sobre el corona virus	intent:myths
sabes si se puede viajar por europa o los vuelos están cancelados	intent:travel
me puedes informar de si es seguro viajar en autobás	intent:travel
tengo mucha urgencia por saber algunos consejos de viaje con esto del corona virus	intent:travel
me podrías informar de si los viajes en avión están cancelados o siguen en pie	intent:travel
algo de información sobre si todavía puedo viajar en autobús	intent:travel
los aviones contagian más de covid que los autos	intent:travel
a qué lugares no se puede viajar	intent:travel
durante cuánto tiempo no se podrán hacer viajes internacionales	intent:travel
medidas de las agenicas de viajes ante covid	intent:travel
a qué países está prohibido viajar ahorita	intent:travel
se puede viajar a la playa	intent:travel
cuándo estarán disponibles los vueltos a canadá	intent:travel
crees que para agosto cancelen mi vuelo a canadá	intent:travel
cuándo podré tomar un vuelo a españa	intent:travel
ya cancelaron los viajes del verano	intent:travel
cuáles son las restricciones que hay para tomar un vuelo internacional	intent:travel
es seguro viajar en avión	intent:travel
cuáles son las restricciones para viajar	intent:travel
dónde consulto si cancelaron mi vuelo por el coronavirus	intent:travel
hay servicios de transporte constante en el aeropuerto de cdmx	intent:travel
es seguro viajar por carretera a cdmx desde querétaro	intent:travel
hay algún retén sanitario que me impida llegar a tijuana por carretera	intent:travel
aplican las mismas restricciones de equipaje de mano durante la contingencia por la pandemia	intent:travel
puedo obtener un reembolso de mi boleto si ya no quiero hacer el viaje porque me puedo contagiar	intent:travel
qué pasa con mi vuelo si se decreta toque de queda y no puedo salir de mi casa	intent:travel
si tengo gripa me dejarán abordar mi vuelo	intent:travel
qué se hace en caso de tener que viajar	intent:travel
es más seguro viajar por bus o avión	intent:travel
para prevenir contagiarme, es mejor caminar o tomar transporte a mi lugar de trabajo	intent:travel
qué medidas de prevención están tomando en los aviones	intent:travel
dime si es recomendable postergar mi viaje a nueva york, cuántos días	intent:travel
es seguro viajar a nueva york ahora	intent:travel
es posible ir en tren a mar del plata ahora o están cancelados los servicios por el virus	intent:travel
qué transportes públicos están funcionando en buenos aires durante la cuarentena	intent:travel
se canceleron los taxis por culpa del corona virus	intent:travel
qué rutas aéreas están operativas en este momento? ¿son muchas las afectadas por el virus	intent:travel
es posible viajar a europa desde buenos aires durante la cuarentena	intent:travel
me podrías aconsejar sobre cómo viajar durante la pandemia	intent:travel
viajes en avión, consejos y recomendaciones en los tiempos del corona	intent:travel
puedo viajar a italia durante el coronavirus si tengo la nacionalidad	intent:travel
las fronteras terrestres de colombia están cerradas por el coronavirus	intent:travel
durante la emergencia están funcionando los trenes de cercanías en madrid	intent:travel
qué tan seguro es subirme a un taxi en época de coronavirus	intent:travel
tengo que usar tapabocas y guantes en el metro de medellín	intent:travel
qué países no han cerrado fronteras aéreas	intent:travel
en estados unidos está permitido viajar en carro	intent:travel
cuándo se podrá viajar por turismo a estados unidos	intent:travel
cómo me entero si cancelaron mi viaje a china	intent:travel
es posible cambiar de provincia en bus dentro de un mismo país	intent:travel
es necesario que cancele mi vuelo a miami	intent:travel
tengo que cancelar mis vacaciones a punta cana por el coronavirus	intent:travel
los vuelos están cancelados por el coronavirus	intent:travel
es peligroso ir a ver a mis amigos en toronto por el virus	intent:travel
el tren todavía funciona	intent:travel
estará cancelado mi viaje en crucero	intent:travel
todavía puedo tomar el metro para ir a trabajar	intent:travel
es arriesgado viajar en tren	intent:travel
se puede viajar sin riesgo por el sudeste asiático	intent:travel
hay servicios de uber y lyft durante la cuarentena	intent:travel
dime si debo cancelar mi vuelo a italia	intent:travel
qué debo saber para planificar un viaje	intent:travel
a qué se refieren las autoridades con la frase viajes domésticos no esenciales	intent:travel
te parece bien que posponga mis vacaciones al caribe	intent:travel
cuáles son las últimas novedades sobre el corona virus	intent:news_and_press
quisiera saber cuáles son las últimas noticias mundiales sobre el corona virus	intent:news_and_press
dime todas las últimas noticias recientes sobre el corona virus, por favor	intent:news_and_press
noticias más recientes sobre el corona virus en el mundo	intent:news_and_press
quiero tener actualizaciones diarias sobre el corona virus	intent:news_and_press
dame todos los comunicados de prensa que han salido por corona virus recientemente	intent:news_and_press
quiero que me des las últimas noticias sobre el corona virus en italia	intent:news_and_press
si puedes dame las últimas actualizaciones sobre el corona virus en españa	intent:news_and_press
podrías darme las últimas noticias sobre el corona virus	intent:news_and_press
información oficial sobre coronavirus	intent:news_and_press
qué ha dicho el presidente sobre la pandemia	intent:news_and_press
principales noticias sobre covid	intent:news_and_press
actualización sobre el covid en wuhan	intent:news_and_press
qué dijo gatell en la conferencia de covid	intent:news_and_press
información de medios oficiales sobre avance del covid en méxico	intent:news_and_press
qué se sabe del covid en el mundo	intent:news_and_press
coronavirus hoy	intent:news_and_press
comunicado del gobierno sobre la nueva fase del covid en méxico	intent:news_and_press
últimas noticias del coronavirus	intent:news_and_press
actualizaciones del coronavirus hoy	intent:news_and_press
dime las últimas noticias mundiales del covid-19	intent:news_and_press
últimas noticias del coronavirus a nivel mundial	intent:news_and_press
noticias coronavirus hoy	intent:news_and_press
proporciona las últimas actualizaciones del coronavirus	intent:news_and_press
dime qué se dijo del covid en las noticias hoy	intent:news_and_press
datos del coronavirus en noticias de españa	intent:news_and_press
qué dijeron hoy del covid-19 en las noticias? ¿cómo vamos	intent:news_and_press
dame una actualización a las 8 de la noche de número de casos confirmados	intent:news_and_press
qué dice la prensa sobre las medidas de confinamiento	intent:news_and_press
puedes darme la editorial de el financiero sobre la respuesta de la secretaría de salud	intent:news_and_press
por favor, las noticias actuales del avance contra el covid	intent:news_and_press
quiero las primeras reacciones de la prensa en el mundo acerca de la declaratoria de pandemia por parte de la oms	intent:news_and_press
dime si según los comunicados oficiales la curva de contagios ya cayó	intent:news_and_press
busca las noticias de ayer sobre las medidas que propone el gobierno para evitar los contagios	intent:news_and_press
busca si hay actualizaciones sobre el número de pacientes recuperados en italia	intent:news_and_press
qué están reportando los medios sobre el número de contagios de hoy	intent:news_and_press
ha habido alguna actualización de parte de la oms	intent:news_and_press
qué ha dicho trump los últimos días sobre el covid	intent:news_and_press
me buscas el comunicado de prensa emitido por el ministerio de salud ayer por favor	intent:news_and_press
qué novedades hay sobre el virus según el país	intent:news_and_press
hay alguna buena noticia respecto a la situación del covid 19 en nueva york	intent:news_and_press
búscame noticias sobre angela merkel y el manejo del covid en alemania	intent:news_and_press
quiero leer sobre el estado de la bolsa internacional en esta pandemia	intent:news_and_press
me contás qué dijeron hoy en la conferencia de prensa matutina	intent:news_and_press
conferencia de prensa de las 9, ¿me contás qué dijeron	intent:news_and_press
quiero conocer la última noticia sobre el virus, gracias	intent:news_and_press
hay alguna novedad sobre el covid en buenos aires	intent:news_and_press
me pasás las últimas actualizaciones sobre el virus en mi ciudad	intent:news_and_press
mantenme al tanto de las últimas novedades del covid19	intent:news_and_press
qué se sabe del coronavirus en houston	intent:news_and_press
reporte informativo de covid19 en barcelona	intent:news_and_press
alértame si hay noticias de coronavirus en bogotá	intent:news_and_press
qué dice la prensa brasilera sobre el coronavirus	intent:news_and_press
noticias de última hora sobre covid19	intent:news_and_press
cuándo tendremos una conferencia de prensa del presidente	intent:news_and_press
noticias sobre los argentinos varados en los aeropuertos del mundo	intent:news_and_press
cuáles son las últimas noticias sobre la vacuna contra el virus	intent:news_and_press
qué noticias nos llegan sobre los infectados en españa	intent:news_and_press
alguna noticia relevante sobre la cura del covid-19	intent:news_and_press
noticias sobre cuánto tiempo durará la cuarentena	intent:news_and_press
qué dice la prensa sobre el número de casos en quebec	intent:news_and_press
dame noticias sobre el coronavirus	intent:news_and_press
qué está pasando con el virus en china en este momento	intent:news_and_press
la prensa tendrá alguna novedad sobre la cantidad de casos en el mundo	intent:news_and_press
necesito una actualización sobre el estado del virus covid 19	intent:news_and_press
qué novedades hay del corona virus	intent:news_and_press
cuál es el último artículo sobre el virus	intent:news_and_press
cuáles son las nuevas acerca del corona virus	intent:news_and_press
quiero saber qué pasa en italia con el virus	intent:news_and_press
puedes actualizarme sobre la pandemia en españa	intent:news_and_press
qué anda pasando en relación al corona virus en gran bretaña	intent:news_and_press
necesito noticias de covid-19 en francia	intent:news_and_press
qué ha publicado la prensa sobre corona virus en india	intent:news_and_press
necesito saber cómo puedo compartir este enlace	intent:share
déjame compartir esta noticia sobre el corona virus	intent:share
quiero compartir toda esta información	intent:share
me hace falta compartir toda la información	intent:share
necesitaría que compartieras el chat	intent:share
puedes compartir este servicio	intent:share
me hace falta que compartas esto	intent:share
te es posible compartir esta información	intent:share
comparte el asistente de coronavirus a todos mis contactos	intent:share
puedo compartir el asistente	intent:share
comparte esto en el chat familiar	intent:share
pasa esta información a mis contactos	intent:share
comparte esto en mi face	intent:share
pon el enlace para el asistente en mi instagram	intent:share
quiero compartir esto	intent:share
quiero mandar esto en el chat	intent:share
compartir vínculo	intent:share
se puede compartir este video	intent:share
compartir a mis amigos lo que acabo de leer	intent:share
quisiera compartir esta información en mi muro	intent:share
compartir enlace	intent:share
comparte esta noticia de el universal en mi facebook	intent:share
dale retweet a esta nota	intent:share
comparte el meme de los que ya están hartos de la cuarentena en facebook	intent:share
manda este link a mi grupo amigos en el whats	intent:share
dale like a esta nota sobre la disminución de contagios	intent:share
me gustaría compartir este video con mis hijos	intent:share
comparte este video de nosotros en la cuarentena al grupo familia	intent:share
comparte este artículo con mi grupo colegas del trabajo de facebook	intent:share
publica el tweet: #quédateencasa te quiero abrazar cuando esto termine	intent:share
cómparte este gráfico en mi muro	intent:share
quiero que le mandes este enlace a mis contactos por correo	intent:share
qué buen reportaje, ponlo en twitter	intent:share
le pasas este link al resto de mis contactos	intent:share
compartir esta información con todos	intent:share
reenvía este chat	intent:share
quiero que todos sepan esto, compártelo	intent:share
esta info es súper importante, ¿podrías compartirla en mis redes sociales	intent:share
mis contactos deben saber esto, ¿me ayudás a compartirla con ellos	intent:share
me gustaría compartir esta información	intent:share
es posible compartir esto con mis contactos? ¿lo hacés	intent:share
estos datos deben ser conocidos por todos. compartí esto en mis redes	intent:share
voy a darle compartir a estos datos	intent:share
quiero enviar esto a través de mis redes sociales	intent:share
quiero compartir esta información con mis amigos	intent:share
me gustaría que compartas estos datos	intent:share
ahora compártelo con mis contactos	intent:share
qué debo pulsar para compartir este chat	intent:share
es posible compartir esta información	intent:share
quiero hacer públicos estos datos	intent:share
puedo compartir este servicio con mis contactos	intent:share
compartí todo esto	intent:share
es necesario que comparta estos datos	intent:share
compártele este servicio a mis contactos	intent:share
comparte con mis contactos el bot de coronavirus	intent:share
hay que compartir esta información	intent:share
por favor comparte estas precauciones con mis contactos	intent:share
compartámosle este servicio a todos mis contactos	intent:share
se puede compartir esta información	intent:share
quiero que compartas esta información	intent:share
necesito compartir este link	intent:share
puedes compartir este artículo	intent:share
hazme el favor de compartir esto	intent:share
comparte nuestro chat	intent:share
podrías compartir esta info en facebook	intent:share
esto lo quiero compartir en instagram	intent:share
cómo se hace para compartir esta información	intent:share
¡saludos cordiales	intent:hi
cómo andamos	intent:hi
buenas tardes, compi	intent:hi
mis saludos cordiales	intent:hi
cómo te encuentras	intent:hi
a los buenos días	intent:hi
buenos días, mi hermano	intent:hi
hola, asistente	intent:hi
¡buenos días	intent:hi
cómo estás, corona	intent:hi
cómo te va, doctor	intent:hi
cómo estás, robot	intent:hi
¡saludos, mi buen asistente	intent:hi
¡hola, amigo	intent:hi
qué me cuentas, doc	intent:hi
¡buen día para ti, doctor	intent:hi
buenos días	intent:hi
¡buenos días	intent:hi
¡hola! ¿estás ahí	intent:hi
hola, doctor	intent:hi
doctor, buenos días	intent:hi
covito, buenos días	intent:hi
buenas tardes, ¿estás	intent:hi
saludos, dr. covi	intent:hi
oye, doctor	intent:hi
saludos informante	intent:hi
qué tal estás hoy corona	intent:hi
hola asistente	intent:hi
cómo estás doc	intent:hi
hey doc, cómo estás	intent:hi
corona doc, cómo estás hoy	intent:hi
estás ahí	intent:hi
hola doc	intent:hi
llamando a mi doctor corona, cambio	intent:hi
buenos días, covid doc	intent:hi
hola, covid doc	intent:hi
cómo estás, corona bot	intent:hi
cómo va todo, coronita	intent:hi
coronita, ¿cómo estás	intent:hi
corona bot, ¿cómo va todo	intent:hi
¡hola, doc cov	intent:hi
buenas noches, doc cov	intent:hi
cómo va todo, coronita	intent:hi
covid doc, ¿cómo vas	intent:hi
qué tal, doc	intent:hi
buenos días, médico personal	intent:hi
qué te cuentas hoy	intent:hi
qué onda	intent:hi
cómo va	intent:hi
qué onda, doctor corona	intent:hi
hola, doctor	intent:hi
ey, doc	intent:hi
hola, tengo una consulta	intent:hi
todo en orden, doc	intent:hi
hola robot coronavirus, ¿cómo estás	intent:hi
buenos días, corona	intent:hi
oiga, doctor corona	intent:hi
buenos días, doctor, ¿cómo está usted	intent:hi
buenas tardes, asistente corona	intent:hi
cómo anda, doctor	intent:hi
qué hubo, doctor	intent:hi
querido covid-19	intent:hi
¡buenas	intent:hi
cómo va eso	intent:hi
qué dice el doctor corona	intent:hi
qué haces	intent:hi
cómo te va	intent:hi
qué tal está, ayudante corona	intent:hi
¡arriba médico coronavirus	intent:hi
cómo va su día, querido doctor	intent:hi
corona doc, despiérte	intent:hi
aló, doc	intent:hi
¡hey, asistente	intent:hi
qué tal, doctor	intent:hi
mil gracias	intent:okay_thanks
no sabes cuánto te lo agradezco	intent:okay_thanks
de corazón, mil gracias	intent:okay_thanks
vale, muchísimas gracias	intent:okay_thanks
de verdad te lo agradezco muchísimo	intent:okay_thanks
estoy muy agradecida	intent:okay_thanks
no sabes lo agradecida que estoy por tu ayuda	intent:okay_thanks
gracias, de verdad, por todo	intent:okay_thanks
¡gracias, mi buen	intent:okay_thanks
te lo agradezco, asistente	intent:okay_thanks
gracias por la información	intent:okay_thanks
agradezco tu apoyo	intent:okay_thanks
eres un amor	intent:okay_thanks
te estoy inmensamente agradecida	intent:okay_thanks
sale, gracias	intent:okay_thanks
va, gracias	intent:okay_thanks
agradezco tu ayuda	intent:okay_thanks
gracias por la información	intent:okay_thanks
sale, gracias	intent:okay_thanks
muy bien, gracias	intent:okay_thanks
mucha gracias por la información	intent:okay_thanks
ok, gracias	intent:okay_thanks
gracias por el update	intent:okay_thanks
buena nota informante, gracias	intent:okay_thanks
gracias por la información informante	intent:okay_thanks
buen trabajo informante, gracias	intent:okay_thanks
muchas gracias informante	intent:okay_thanks
te agradezco la ayuda	intent:okay_thanks
gracias por la info	intent:okay_thanks
buena info, gracias	intent:okay_thanks
gracias por mantenerme al tanto	intent:okay_thanks
gracias por existir doc	intent:okay_thanks
ok, gracias	intent:okay_thanks
entendido, gracias	intent:okay_thanks
ya entiendo, muchas gracias	intent:okay_thanks
gracias por todo	intent:okay_thanks
gracias por la información	intent:okay_thanks
ya veo, gracias por la explicación	intent:okay_thanks
¡te agradezco un montón	intent:okay_thanks
ahora estoy mejor informada, gracias	intent:okay_thanks
sos un genio, gracias	intent:okay_thanks
ml gracias por los datos aportados	intent:okay_thanks
le agradezco la información, covid bot	intent:okay_thanks
muchas, muchas gracias, era justo lo que necesitaba	intent:okay_thanks
gracias por orientarme	intent:okay_thanks
mil gracias por la ayuda	intent:okay_thanks
por los datos, gracias	intent:okay_thanks
estoy agradecido contigo	intent:okay_thanks
se lo agradezco, doc	intent:okay_thanks
gracias, doctor corona, eres un amor	intent:okay_thanks
ay, muchas gracias por la ayuda	intent:okay_thanks
fue de mucha ayuda la información, ¡gracias	intent:okay_thanks
gracias por el apoyo y la información que me brindó	intent:okay_thanks
¡mil gracias	intent:okay_thanks
¡qué bueno poder contar con vos! gracias	intent:okay_thanks
realmente me fue de mucha ayuda la información dada.¡gracias	intent:okay_thanks
gracias por aclararme el panorama	intent:okay_thanks
¡muchas gracias por tu ayuda	intent:okay_thanks
te agradezco por la información	intent:okay_thanks
qúe bueno saber todo eso, muchas gracias	intent:okay_thanks
bueno pues, muchas gracias	intent:okay_thanks
bueno pues, robot corona, se le agradece	intent:okay_thanks
gracias por asistirme	intent:okay_thanks
que gracias de todos aquí por la ayuda	intent:okay_thanks
buenísimo, gracias	intent:okay_thanks
te lo agradezco mucho	intent:okay_thanks
quiero agradecerte por la información	intent:okay_thanks
excelente, gracias	intent:okay_thanks
gracias por todo	intent:okay_thanks
le agradezco de corazón toda la información que me da	intent:okay_thanks
quisiera hacer una donación	intent:donate
puedes decirme cómo pudiera hacer una donación	intent:donate
me puedes guiar para hacer una donación	intent:donate
me apetece hacer una inversión de dinero en la ciudad de roma	intent:donate
quiero donar ahora, ¿me ayudas	intent:donate
donación para áfrica en este momento	intent:donate
puedo donar a puebla	intent:donate
haz una donación para méxico	intent:donate
me gustaría donar algo para apoyar a la gente pobre	intent:donate
quiero hacer un donativo, por favor	intent:donate
dona algo a mi ciudad	intent:donate
podrías hacer una pequeña donación a china, por fa	intent:donate
dale a donar	intent:donate
dónale algo a uruguay	intent:donate
cómo hacer una donación	intent:donate
quisiera donar a la causa	intent:donate
lugares para realizar donaciones	intent:donate
quiero donar un poco	intent:donate
donar a esto, por favor	intent:donate
vamos a hacer una donación, ¿sabes cómo	intent:donate
cómo le hago para donar	intent:donate
quiero donar a esta causa	intent:donate
quiero donar a médicos sin fronteras	intent:donate
me gustaría hacer una donación a esa org	intent:donate
dona ya	intent:donate
quiero investir una pequeña cantidad en esta startup	intent:donate
quiero donar plata a las localidades rurales de chile	intent:donate
es posible hacer donaciones a municipalidades	intent:donate
me gustaría hacer algo por ayudar a la comunidad hispana de nueva york	intent:donate
quiero ayudar a la localidad de sonora	intent:donate
cómo ayudar a los migrantes mexicanos deportados en riesgo	intent:donate
quiero hacer una donación, ¿cómo puedo hacerlo	intent:donate
me gustaría hacer una donación a una ong que esté trabajando con enfermos	intent:donate
cómo puedo hacer una donación a la provincia de chaco	intent:donate
bot, ¿podés hacer una donación en mi nombre	intent:donate
creo que es necesario ayudar a los que menos tienen, ¿podemos hacer una donación a misiones	intent:donate
es importante que todos ayudemos en esta coyuntura, ¿podrías hacer una donación para el hospital local	intent:donate
podríamos hacer una donación a la provincia de jujuy	intent:donate
quiero invertir en ayudas para desempleados	intent:donate
invertir dinero en beneficios a parados	intent:donate
donar de mi cuenta bancaria	intent:donate
me gustaría aportar una donación a la ciudad de bérgamo	intent:donate
tengo recursos que voy a donar para enfermos en madrid	intent:donate
ayuda para donar a hospitales del chocó	intent:donate
cómo hago para donar	intent:donate
quiero donarle plata a la causa	intent:donate
voy a mandarle una donación a la gente de nueva york	intent:donate
quiero invertir en el pueblo de méxico df	intent:donate
me gustaría donarle algo a la causa	intent:donate
no se si haya forma de ayudar con una donación	intent:donate
será que es posible donar	intent:donate
quiero que hagas una donación	intent:donate
necesito que dones	intent:donate
cómo hago para donar en la paz, bolivia	intent:donate
donación ahora en santiago de chile	intent:donate
preciso hacer una donación	intent:donate
deseo contribuir con dinero en guatemala	intent:donate
voy a enviar ayuda económica para haití	intent:donate
cómo puedo donarles a los más necesitados durante la pandemia	intent:donate
ayúdame a donar plata a italia y españa	intent:donate
haz que pueda donar dinero a los más necesitados en mi localidad	intent:donate
se puede realizar donaciones a través de este asistente	intent:donate
quiero ayudar a ecuador ¿cómo puedo donarles	intent:donate
es posible donar dólares	intent:donate
quiero colaborar con algo de dinero para mali	intent:donate
dame información sobre cómo donar dinero	intent:donate
hacer una donación ahora	intent:donate
