combien de décès corona au pays bas	intent:latest_numbers
combien de décès enfants coronavirus en europe	intent:latest_numbers
statistiques évolution corona depuis deux semaines en france	intent:latest_numbers
statistiques évolution coronavirus sur deux mois en europe	intent:latest_numbers
statistiques nouvelles infections coronavirus par jour en france	intent:latest_numbers
statistiques décès personnes saines en france	intent:latest_numbers
nombre décès de corona en europe par tranche d'âge	intent:latest_numbers
combien d'enfants sains sont décédés de corona en roumanie	intent:latest_numbers
nombre de personnes sans antécédants médicaux décédées de corona en italie	intent:latest_numbers
confinés du covid dans le monde	intent:latest_numbers
cherche cas coronavirus france	intent:latest_numbers
il y a combien de guéris en europe	intent:latest_numbers
il y a des morts du covid 19 aux états-unis	intent:latest_numbers
combien de personnes en réanimation	intent:latest_numbers
trouve le nombre de personnes malades	intent:latest_numbers
contamination coronavirus afrique	intent:latest_numbers
personnes guéries du coronavirus	intent:latest_numbers
combien de cas en europe	intent:latest_numbers
nombre de cas dans le monde	intent:latest_numbers
combien de personnes ont guéri du coronavirus	intent:latest_numbers
nombre de cas aux états-unis	intent:latest_numbers
montre dernières statistiques covid-19	intent:latest_numbers
combien de morts en france du coronavirus	intent:latest_numbers
morts france coronavirus	intent:latest_numbers
donne-moi le nombre de patients en réanimation	intent:latest_numbers
combien d'infectés en 24h en france	intent:latest_numbers
montre-moi les courbes de progression de l'épidémie	intent:latest_numbers
nombre de cas en afrique	intent:latest_numbers
statistiques coronavirus italie	intent:latest_numbers
donne-moi le taux de guérison du coronavirus	intent:latest_numbers
y a-t-il des nouveaux cas en france	intent:latest_numbers
quel est l'âge moyen des personnes qui attrapent le coronavirus	intent:latest_numbers
combien de nouveaux cas au canada aujourd'hui	intent:latest_numbers
quelle est la tranche d'âge la plus affectée par le virus au québec	intent:latest_numbers
pays coronavirus taux de mortalité le plus élevé	intent:latest_numbers
nombre de personnes mortes du coronavirus	intent:latest_numbers
nombre de nouveaux cas pendant les deux dernières semaines au canada	intent:latest_numbers
pourcentage de personnes infectées qui sont asymptomatiques	intent:latest_numbers
quel est le nombre d'entrées en réanimation aujourd'hui en france	intent:latest_numbers
taux de guérison du coronavirus en europe	intent:latest_numbers
pourcentage de guéris du covid-19 en france	intent:latest_numbers
nombre de soignants infectés par le coronavirus dans le monde	intent:latest_numbers
combien de personnes en réanimation en france	intent:latest_numbers
il y a eu combien de morts en italie aujourd'hui	intent:latest_numbers
estimation du nombre de cas à londres	intent:latest_numbers
pourcentage de patients guéris du coronavirus	intent:latest_numbers
statistiques décès par tranche d'âge	intent:latest_numbers
quel est le nombre de cas en région parisienne	intent:latest_numbers
nombre de nouveaux cas en allemagne	intent:latest_numbers
taux d'hospitalisations inde	intent:latest_numbers
nombre de personnes infectées au covid-19 au nigéria	intent:latest_numbers
quelle ville américaine est la plus touchée	intent:latest_numbers
statistiques des patients sous assistance respiratoire	intent:latest_numbers
quel est le nombre de cas en chine	intent:latest_numbers
quel taux de survie du covid-19 en france	intent:latest_numbers
statistiques virus italie	intent:latest_numbers
décès usa coronavirus	intent:latest_numbers
quelle proportion de la population est immunisée en belgique	intent:latest_numbers
informations sur la contamination au brésil	intent:latest_numbers
progression des hospitalisations en mars	intent:latest_numbers
quel est le nombre des nouveaux cas d'infection depuis hier en france	intent:latest_numbers
combien de personnes sont en réanimation sur le territoire français	intent:latest_numbers
combien de sorties de réanimation aujourd'hui	intent:latest_numbers
nombre total de décès à new york	intent:latest_numbers
le taux de mortalité en belgique	intent:latest_numbers
progression des statistiques depuis hier	intent:latest_numbers
les 10 pays les plus touchés par la pandémie covid 19	intent:latest_numbers
le taux de mortalité la plus bas en europe	intent:latest_numbers
comment protéger mes enfants du virus	intent:protect_yourself
comment protéger la maison	intent:protect_yourself
combien de temps dois-je me laver les mains	intent:protect_yourself
dois-je porter un masque chez moi	intent:protect_yourself
quelle méthode pour protéger mon grand-père	intent:protect_yourself
comment se protéger du covid-19	intent:protect_yourself
type de masque efficace	intent:protect_yourself
peut-on rendre visite à ses grand-parents	intent:protect_yourself
doit-on porter des gants pour sortir	intent:protect_yourself
quelle protection mains utiliser contre le coronavirus	intent:protect_yourself
puis-je utiliser le masque de protection plusieurs fois	intent:protect_yourself
faut-il désinfecter mes chaussures avant d'entrer dans la maison	intent:protect_yourself
une écharpe autour de la bouche c'est assez contre le corona	intent:protect_yourself
quelle épaisseur pour les gants	intent:protect_yourself
quel type de masque de protection contre le corona	intent:protect_yourself
dois-je couvrir mes cheveux pour me protéger	intent:protect_yourself
dois-je désinfecter les emballages de mes courses	intent:protect_yourself
où trouver masques coronavirus	intent:protect_yourself
comment fabriquer un masque	intent:protect_yourself
comment se laver les mains	intent:protect_yourself
comment ne pas attraper le corona	intent:protect_yourself
comment se protéger contre le virus	intent:protect_yourself
infos stop coronavirus	intent:protect_yourself
gestes barrière coronavirus	intent:protect_yourself
c’est quoi les consignes	intent:protect_yourself
comment se protéger du coronavirus	intent:protect_yourself
gestes barrières coronavirus	intent:protect_yourself
faut-il porter des gants en latex	intent:protect_yourself
avec quoi désinfecter mes courses	intent:protect_yourself
comment se protéger du covid-19	intent:protect_yourself
protection coronavirus personnes agées	intent:protect_yourself
puis-je sortir sans masque	intent:protect_yourself
est-ce que nettoyer les objets protège du virus	intent:protect_yourself
consignes protection coronavirus	intent:protect_yourself
comment me protéger pour aller faire les courses	intent:protect_yourself
à quelle fréquence faut-il se laver les mains	intent:protect_yourself
à quoi ça sert de tousser dans son coude	intent:protect_yourself
entretien masque tissu	intent:protect_yourself
dois-je désinfecter mes courses	intent:protect_yourself
dois-je protéger mes yeux	intent:protect_yourself
comment tester l'efficacité d'un masque	intent:protect_yourself
quels types de gants porter	intent:protect_yourself
coronavirus prévention étapes à suivre en rentrant chez soi	intent:protect_yourself
pourcentage d'alcool requis pour désinfection efficace	intent:protect_yourself
comment protéger mes grand-parents du coronavirus	intent:protect_yourself
comment me protéger si un membre de ma famille est infecté	intent:protect_yourself
combien de temps dois-je laver mes mains pour éliminer le coronavirus	intent:protect_yourself
comment fabriquer un masque en tissu	intent:protect_yourself
les lingettes c'est assez pour désinfecter les courses	intent:protect_yourself
quel type de gants est le meilleur	intent:protect_yourself
protection coronavirus enfants	intent:protect_yourself
est-ce qu'il faut mettre des gants pour faire ses courses	intent:protect_yourself
comment laver un masque en tissu	intent:protect_yourself
c'est mieux le gel hydroalcoolique ou l'eau et le savon	intent:protect_yourself
quelle distance faut-il laisser entre les personnes	intent:protect_yourself
comment me protéger si je prends les transports en commun	intent:protect_yourself
est-ce que je dois changer de vêtements quand je rentre chez moi	intent:protect_yourself
meilleurs conseils pour se protéger du coronavirus	intent:protect_yourself
mesures préventives covid-19	intent:protect_yourself
quelles mesures prendre pour aller faire ses courses	intent:protect_yourself
quelle est l'efficacité des masques	intent:protect_yourself
efficacité gel hydroalcoolique	intent:protect_yourself
distanciation sociale, c'est quoi	intent:protect_yourself
le confinement est-il la meilleure solution	intent:protect_yourself
comment se procurer un masque médical	intent:protect_yourself
application de distanciation sociale	intent:protect_yourself
différences savon et gel hydroalcoolique	intent:protect_yourself
comment protéger ses proches âgés	intent:protect_yourself
que faire pour me protéger contre le coronavirus	intent:protect_yourself
dans quelle mesure un masque en tissu me protège-t-il	intent:protect_yourself
efficacité de l'autoconfinement	intent:protect_yourself
comment mieux vivre le confinement	intent:protect_yourself
merci docteur	intent:okay_thanks
merci pour tes infos précieuses	intent:okay_thanks
merci bot	intent:okay_thanks
merci beaucoup	intent:okay_thanks
merci pour ta réponse	intent:okay_thanks
je tiens à te remercier pour cette info	intent:okay_thanks
merci infiniment docteur	intent:okay_thanks
je te remercie	intent:okay_thanks
merci doc	intent:okay_thanks
merci pour cette info	intent:okay_thanks
merci doc corona	intent:okay_thanks
merci pour ton aide bot	intent:okay_thanks
je te remercie pour ces informations	intent:okay_thanks
ok robot	intent:okay_thanks
merci bot médecin	intent:okay_thanks
merci pour votre contribution	intent:okay_thanks
merci pour ton aide	intent:okay_thanks
d'accord, merci bot	intent:okay_thanks
merci beaucoup bot	intent:okay_thanks
je te remercie bot	intent:okay_thanks
ok, merci doc	intent:okay_thanks
merci pour les informations	intent:okay_thanks
très instructif, merci	intent:okay_thanks
je te remercie docteur bot	intent:okay_thanks
tu es génial, merci	intent:okay_thanks
super merci	intent:okay_thanks
merci énormément pour ton aide	intent:okay_thanks
c'est parfait merci	intent:okay_thanks
très bien merci doc	intent:okay_thanks
merci beacoup cher doc corona	intent:okay_thanks
j’en suis très reconnaissant	intent:okay_thanks
alors un grand bravo	intent:okay_thanks
chapeau bas pour toute cette aide	intent:okay_thanks
je ne te remercierai jamais assez	intent:okay_thanks
merci c'est cool	intent:okay_thanks
cimer albert	intent:okay_thanks
cimer le bot	intent:okay_thanks
cimer doc	intent:okay_thanks
cimer docteur	intent:okay_thanks
cimer mec	intent:okay_thanks
cimer pour les infos	intent:okay_thanks
cimer mon frère	intent:okay_thanks
merci beaucoup doc	intent:okay_thanks
merci beaucoup pour ton aide, bot	intent:okay_thanks
super, merci doc	intent:okay_thanks
merci pour ces infos docteur corona	intent:okay_thanks
je te remerci docteur corona	intent:okay_thanks
grand merci à toi	intent:okay_thanks
t'es le meilleur, merci doc	intent:okay_thanks
je sais pas ce que je ferais sans toi, mille fois merci	intent:okay_thanks
je te remercie, à plus	intent:okay_thanks
ton aide m'a été précieuse	intent:okay_thanks
ok, c'est bon, j'ai compris, merci	intent:okay_thanks
ça marche doc, merci	intent:okay_thanks
super merci beaucoup	intent:okay_thanks
merci tu me sauves	intent:okay_thanks
cimer	intent:okay_thanks
je te remercie	intent:okay_thanks
trop reconnaissante	intent:okay_thanks
vous me voyez pleine de gratitude	intent:okay_thanks
je te remercie grandement	intent:okay_thanks
a qui puis-je faire un don pendant cette crise	intent:donate
donner de l'argent à des organisations contre corona	intent:donate
donne-moi une liste des organisations auxquelles faire un don contre le corona virus	intent:donate
comment faire un don pour le combat contre corona	intent:donate
don associations corona	intent:donate
comment faire un don aux associations touchées	intent:donate
transférer de l'argent à une association	intent:donate
faire un don maintenant crise corona virus	intent:donate
je voudrais aider financièrement l’afrique	intent:donate
je voudrais envoyer de l’argent pour aider les malades en iran	intent:donate
je voudrais donner de l’argent aux hôpitaux de paris	intent:donate
j'aimerais envoyer un peu d'argent au mexique	intent:donate
je souhaite faire un don pour sauver les victimes du corona	intent:donate
je veux aider les hopitaux au maroc en leur envoyant de l'argent	intent:donate
comment je peux donner de l’argent pour aider les hôpitaux	intent:donate
faire un don, quelles associations	intent:donate
comment je peux faire un don pour les pays touchés par le coronavirus	intent:donate
faire un don coronavirus	intent:donate
comment faire un don en ligne	intent:donate
comment aider financièrement la recherche scientifique contre le covid-19	intent:donate
pour qui je peux donner de l’argent pour aider à améliorer la situation sanitaire	intent:donate
je veux envoyer des fonds à mulhouse	intent:donate
comment envoyer de l'argent pour un hôpital	intent:donate
je voudrais envoyer de l'argent en espagne	intent:donate
envoi argent belgique	intent:donate
aide-moi à faire un don	intent:donate
dons hôpitaux de france	intent:donate
dons hôpitaux de belgique	intent:donate
est-possible de faire un don pour l'italie	intent:donate
je veux faire un don pour le coronavirus, aide-moi	intent:donate
faire un don pour le covid-19	intent:donate
comment donner de l'argent	intent:donate
comment je peux aider	intent:donate
coronavirus associations pour aider	intent:donate
cagnotte pour le covid-19	intent:donate
prépare un don pour les soignants	intent:donate
je veux effectuer un don pour les hôpitaux de france	intent:donate
comment contrbuer à l'effort sanitaire	intent:donate
quels sont les sites pour envoyer des fonds	intent:donate
je voudrais envoyer des fonds pour soutenir les services de réanimation	intent:donate
je veux contribuer à la lutte contre le covid19	intent:donate
aide-moi à faire un don pour lutter contre le virus	intent:donate
comment faire si je veux donner de l'argent pour soutenir la cause covid-19	intent:donate
comment faire un don à une asso en france dans le cadre de la lutte contre le coronavirus	intent:donate
faisons un don à la cause covid-19	intent:donate
je veux donner de l'argent pour contribuer à la cause covid-19	intent:donate
je veux contribuer financièrement à la recherche sur le covid-19 à lyon	intent:donate
comment envoyer un don pour la recherche sur le covid-19	intent:donate
combien je peux contribuer	intent:donate
je voudrais faire un don	intent:donate
aider les victimes financièrement	intent:donate
contribution coronavirus	intent:donate
fonds de solidarité covid 19	intent:donate
donner de l’argent pour le virus	intent:donate
ong dons nouveau coronavirus	intent:donate
fonds pour soutenir les pays touchés	intent:donate
donne des sous à la recherche contre le virus	intent:donate
donne à la recherche	intent:donate
fais un virement contre le virus	intent:donate
donne à la croix rouge	intent:donate
aide les gens qui en ont besoin	intent:donate
envoie de l'argent à la somalie	intent:donate
aide les habitants de l'est	intent:donate
fais un don aux hopitaux de france	intent:donate
donne 100 euros à une association	intent:donate
comment je peux faire un don aux hôpitaux	intent:donate
associations pour faire un don coronavirus	intent:donate
a qui je peux faire un don pour aider la recherche sur le coronavirus	intent:donate
liste associations qui récoltent des dons covid-19	intent:donate
dis-moi comment je peux donner de l'argent pour l'italie	intent:donate
donner de l'argent coronavirus france	intent:donate
comment donner argent coronavirus	intent:donate
quels sont les organismes qui récoltent des fonds pour lutter contre le coronavirus	intent:donate
tu peux me dire où faire un don	intent:donate
j'ai envie d'aider la recherche sur le coronavirus en faisant un don	intent:donate
période d'incubation du coronavirus	intent:what_is_corona
taille du virus	intent:what_is_corona
durée de vie du virus surface en béton	intent:what_is_corona
particularités coronavirus	intent:what_is_corona
plus de détails stp	intent:what_is_corona
y'a-t-il d'autres coronavirus	intent:what_is_corona
a quelle temperature meurt le coronavirus	intent:what_is_corona
mutation du virus	intent:what_is_corona
c’est quoi le covid 19	intent:what_is_corona
maladie covid 19	intent:what_is_corona
qu’est-ce que fait le corona	intent:what_is_corona
que sait-on du coronavirus	intent:what_is_corona
ça veut dire quoi covid 19	intent:what_is_corona
c'est quoi le coronavirus	intent:what_is_corona
informations coronavirus	intent:what_is_corona
qu'est-ce que le corona	intent:what_is_corona
donne-moi des infos sur le coronavirus	intent:what_is_corona
d'où vient le coronavirus	intent:what_is_corona
qu'est-ce que le sars-cov-2	intent:what_is_corona
différence entre le sars et le coronavirus	intent:what_is_corona
origine coronavirus	intent:what_is_corona
donne-moi des infos sur le coronavirus	intent:what_is_corona
qu'est-ce que tu peux me dire sur le coronavirus	intent:what_is_corona
quand a démarré l'épidémie	intent:what_is_corona
combien de chance ai-je de mourir si je suis infecté par le coronavirus	intent:what_is_corona
c'est douloureux le covid	intent:what_is_corona
signes malade coronavirus	intent:what_is_corona
de quand date le covid	intent:what_is_corona
qu'est-ce que le coronavirus	intent:what_is_corona
fausses informations coronavirus	intent:what_is_corona
combien de temps pour guérir de la covid-19	intent:what_is_corona
infos dépistage coronavirus	intent:what_is_corona
y a-t-il des remèdes contre le coronavirus	intent:what_is_corona
temps moyen d'incubation du virus	intent:what_is_corona
c'est quoi le covid-19	intent:what_is_corona
de quand date le covid-19	intent:what_is_corona
qui a decouvert le covid-19	intent:what_is_corona
découverte covid-19	intent:what_is_corona
explications coronavirus	intent:what_is_corona
détails coronavirus	intent:what_is_corona
source covid-19	intent:what_is_corona
mutation coronavirus	intent:what_is_corona
transmission coronavirus	intent:what_is_corona
ce qu'on sait sur l'origine du coronavirus	intent:what_is_corona
combien existe-t-il de coronavirus	intent:what_is_corona
le coronavirus c'est quoi	intent:what_is_corona
je veux des informations sur le covid-19	intent:what_is_corona
date apparition coronavirus	intent:what_is_corona
d'où vient le coronavirus	intent:what_is_corona
à quelle date le coronavirus est arrivé en europe	intent:what_is_corona
description des symptômes du covid-19	intent:what_is_corona
origine du covid-19	intent:what_is_corona
vaccin ou traitement	intent:what_is_corona
qui était le patient zéro du covid-19	intent:what_is_corona
période d'incubation du coronavirus	intent:what_is_corona
combien de temps le coronavirus peut survivre dans l'air	intent:what_is_corona
qu'est-ce qu'un patient asymptomatique	intent:what_is_corona
informations générales covid-19	intent:what_is_corona
origine du coronavirus	intent:what_is_corona
différences coronavirus et covid-19	intent:what_is_corona
immunité virale après la première infection au covid-19	intent:what_is_corona
est-on contagieux avant l'apparition de symptômes	intent:what_is_corona
comment traiter le coronavirus chez soi	intent:what_is_corona
dis m'en plus sur le coronavirus	intent:what_is_corona
que veut dire covid 19	intent:what_is_corona
quelles sont les différentes désignations du coronavirus	intent:what_is_corona
d'où vient le covid 19	intent:what_is_corona
y aura-il un covid 20 avec la possible mutation du covid 19	intent:what_is_corona
d'où vient le malade zéro du covid 19	intent:what_is_corona
que veut dire l'immunité collective contre le coronavirus	intent:what_is_corona
bref historique sur la propagation de la pandémie covid 19	intent:what_is_corona
c'est quoi un porteur asymptomatique du covid 19	intent:what_are_symptoms
j'ai de la fatigue et de la fièvre sans toux, mais avec des convulsions thoraciques, puis-je être atteint du coronavirus	intent:what_are_symptoms
dois-je m'inquiéter d'une possible atteinte du covid 19 après 8 jours de fièvre sans autres symptômes	intent:what_are_symptoms
quelles différences de symptômes entre une grippe saisonnière ou une bronchite et le covid 19	intent:what_are_symptoms
comment être sûr qu'on a attrapé le corona virus	intent:what_are_symptoms
est-ce que le covid-19 ressemble à un rhume	intent:what_are_symptoms
est-ce que le covid-19 est comme un genre de grippe	intent:what_are_symptoms
corona virus toux grasse ou sèche	intent:what_are_symptoms
est-ce que le corona provoque une sensation d'étouffement	intent:what_are_symptoms
est-ce qu'avoir le covid-19 provoque des crises d'asthme	intent:what_are_symptoms
la voix enrouée est-elle un symptôme du coronavirus	intent:what_are_symptoms
douleurs articulaires corona	intent:what_are_symptoms
tachycardie soudaine infection corona	intent:what_are_symptoms
premiers signes infection corona	intent:what_are_symptoms
infection corona symptômes atypiques	intent:what_are_symptoms
infection corona symptômes légers	intent:what_are_symptoms
infection coronavirus absence totale de symptômes	intent:what_are_symptoms
est-ce que ça brûle les yeux	intent:what_are_symptoms
symptômes du covid 19	intent:what_are_symptoms
cherche les signes du virus	intent:what_are_symptoms
on a le nez qui coule avec le corona	intent:what_are_symptoms
est-ce qu’on a du mal à respirer	intent:what_are_symptoms
comment on sait si on a le covid	intent:what_are_symptoms
problèmes pour respirer virus	intent:what_are_symptoms
problèmes poumons coronavirus	intent:what_are_symptoms
dis-moi les signes du covid 19	intent:what_are_symptoms
donne-moi les symptômes du coronavirus	intent:what_are_symptoms
symptômes coronavirus enfants	intent:what_are_symptoms
fièvre et toux coronavirus	intent:what_are_symptoms
symptômes graves corona	intent:what_are_symptoms
quels sont les symptômes typiques du covid-19	intent:what_are_symptoms
comment savoir si j'ai contracté le coronavirus	intent:what_are_symptoms
coronavirus toux sèche ou grasse	intent:what_are_symptoms
quels sont les symptômes du coronavirus chez le nourrisson	intent:what_are_symptoms
mal poitrine coronavirus	intent:what_are_symptoms
différence symptômes grippe et coronavirus	intent:what_are_symptoms
symptômes méconnus coronavirus	intent:what_are_symptoms
coronavirus chez l'enfant	intent:what_are_symptoms
peut-on transmettre le virus sans symptômes	intent:what_are_symptoms
symptômes les plus fréquents coronavirus	intent:what_are_symptoms
différence de symptômes entre le coronavirus et la grippe	intent:what_are_symptoms
comment savoir si on a le coronavirus	intent:what_are_symptoms
quand aller à l'hôpital	intent:what_are_symptoms
nez qui coule covid-19	intent:what_are_symptoms
symptômes nécessaires dépistage coronavirus canada	intent:what_are_symptoms
temps avant que les symptômes ne se manifestent	intent:what_are_symptoms
mal de tête coronavirus	intent:what_are_symptoms
quels sont les symptômes les plus fréquent du covid-19	intent:what_are_symptoms
température corona	intent:what_are_symptoms
mal aux yeux symtôme corona	intent:what_are_symptoms
quels sont les symptômes rares du covid-19	intent:what_are_symptoms
type de toux coronavirus	intent:what_are_symptoms
la respiration difficile c'est la grippe ou le corona	intent:what_are_symptoms
auto-diagnostic covid-19	intent:what_are_symptoms
liste des symptômes du covid-19	intent:what_are_symptoms
quels sont les symptômes les plus courants quand on a le coronavirus	intent:what_are_symptoms
comment je peux savoir si j'ai le coronavirus ou la grippe	intent:what_are_symptoms
fièvre maux de tête coronavirus	intent:what_are_symptoms
c'est quel genre de toux pour le coronavirus	intent:what_are_symptoms
courbatures symptôme coronavirus	intent:what_are_symptoms
comment savoir si on l'a quand on est asymptomatique	intent:what_are_symptoms
peut-on s'autodiagnostiquer	intent:what_are_symptoms
quand apparaissent les premiers symptômes	intent:what_are_symptoms
mal de gorge aigu, dois-je m'inquiéter	intent:what_are_symptoms
premiers symptômes du coronavirus	intent:what_are_symptoms
les symptômes sont-ils les mêmes pour toutes les tranches d'âge	intent:what_are_symptoms
doit-on s'alarmer si on quelques symptômes	intent:what_are_symptoms
quels sont les signes du coronavirus	intent:what_are_symptoms
effets du coronavirus	intent:what_are_symptoms
signes évidents du coronavirus	intent:what_are_symptoms
symtômes toux coronavirus	intent:what_are_symptoms
syndrome d'anosmie et covid19	intent:what_are_symptoms
la perte de l'odorat et du goût est-elle un symptôme du coronavirus	intent:what_are_symptoms
comment distinguer les symptômes de la grippe et du covid19	intent:what_are_symptoms
puis-je n'éprouver qu'une partie des symptômes du coronavirus	intent:what_are_symptoms
le virus se propage-t-il à travers la terre	intent:how_does_corona_spread
puis-je attraper le virus à 2m si une personne éternue vers moi	intent:how_does_corona_spread
est-ce que le coronavirus peut se propager à travers le ventilation d'un l'immeuble	intent:how_does_corona_spread
un porteur sain peut-il transmettre le virus aux autres	intent:how_does_corona_spread
une personne guérie peut-elle transmettre le virus aux autres	intent:how_does_corona_spread
est-ce que le virus se transmet par les larmes	intent:how_does_corona_spread
taux de propagation coronavirus	intent:how_does_corona_spread
taux de propagation coronavirus en été	intent:how_does_corona_spread
coronavirus contamination	intent:how_does_corona_spread
qui peut propager le corona	intent:how_does_corona_spread
dis-moi comment on transmet le corona	intent:how_does_corona_spread
transmission covid 19	intent:how_does_corona_spread
coronavirus dans la nourriture	intent:how_does_corona_spread
je suis malade si on tousse sur moi	intent:how_does_corona_spread
comment se fait la transmission du coronavirus	intent:how_does_corona_spread
le confinement est efficace pour arrêter la propagation du virus	intent:how_does_corona_spread
si je vis avec une personne contaminée, suis-je aussi contaminé	intent:how_does_corona_spread
vitesse propagation covid-19	intent:how_does_corona_spread
transmission coronavirus allaitement	intent:how_does_corona_spread
comment éviter la propagation du virus	intent:how_does_corona_spread
transmission coronavirus	intent:how_does_corona_spread
comment éviter de transmettre le virus	intent:how_does_corona_spread
à quelle distance des gens suis-je en sécurité	intent:how_does_corona_spread
coronavirus transports en commun	intent:how_does_corona_spread
combien de temps le coronavirus reste sur les vêtements	intent:how_does_corona_spread
à quoi sert le confinement	intent:how_does_corona_spread
comment se transmet le virus	intent:how_does_corona_spread
le coronavirus se transmet par le sang	intent:how_does_corona_spread
comment se propage le coronavirus	intent:how_does_corona_spread
attraper virus yeux	intent:how_does_corona_spread
combien de temps le coronavirus reste-t-il dans l'air après un éternuement	intent:how_does_corona_spread
une femme enceinte peut-elle transmettre le virus à son foetus	intent:how_does_corona_spread
est-ce que la salive transmet le covid-19	intent:how_does_corona_spread
le coronavirus ça circule dans l'air	intent:how_does_corona_spread
comment vient le corona	intent:how_does_corona_spread
combien de temps le corona reste sur les mains	intent:how_does_corona_spread
les aliments peuvent-ils être contaminés	intent:how_does_corona_spread
le courrier ça contamine	intent:how_does_corona_spread
eau du robinet transmision coronavirus	intent:how_does_corona_spread
comment on attrape le coronavirus	intent:how_does_corona_spread
est-ce que le coronavirus se propage plus vite que la grippe	intent:how_does_corona_spread
nombre moyen de personnes qu'un malade du coronavirus contamine	intent:how_does_corona_spread
dis-moi si le coronavirus reste en suspension dans l'air	intent:how_does_corona_spread
combien de jours les malades du coronavirus doivent rester isolés	intent:how_does_corona_spread
pourquoi le covid-19 se propage aussi vite	intent:how_does_corona_spread
solutions pour stopper la propagation du coronavirus	intent:how_does_corona_spread
combien de temps on est contagieux avec le covid-19	intent:how_does_corona_spread
est-ce qu'on peut contaminer les autres pendant la période d'incubation	intent:how_does_corona_spread
informations durée de survie du coronavirus	intent:how_does_corona_spread
à quelle vitesse le virus se propage-t-il	intent:how_does_corona_spread
durée de contamination potentielle d'une poignée de porte	intent:how_does_corona_spread
est-il vrai que le coronavirus ne se propage pas dans l'air	intent:how_does_corona_spread
quels sont les modes de propagation du covid 19	intent:how_does_corona_spread
le virus peut-il pénétrer dans l'organisme humain à travers des plaies	intent:how_does_corona_spread
est-ce que le covid 19 est sexuellement transmissible	intent:how_does_corona_spread
jusqu'à quelle distance les gouttelettes d'éternument sont-elles susceptibles de se projeter	intent:how_does_corona_spread
s'embrasser et se serrer la main constitue-t-il un risque de propagation	intent:how_does_corona_spread
le virus est-il transmissible par transfusion sanguine	intent:how_does_corona_spread
la mère enceinte peut-elle transmettre le virus au fœtus	intent:how_does_corona_spread
coronavirus propagation sans contact physique	intent:how_does_corona_spread
les modes de propagation du coronavirus connus à ce jour	intent:how_does_corona_spread
coronavirus et propagation par les objets	intent:how_does_corona_spread
est-ce que les puces transmettent le covid-19	intent:how_does_corona_spread
coronavirus propagation par le mucus nasal	intent:how_does_corona_spread
est-ce que les oiseaux peuvent transmettre le corona	intent:can_i_get_from_feces_animal_pets
le steak tartare est-il dangereux	intent:can_i_get_from_feces_animal_pets
mon lapin peut il attraper le coronavirus	intent:can_i_get_from_feces_animal_pets
poisson cru, danger	intent:can_i_get_from_feces_animal_pets
les excréments d'oiseaux sont-ils dangereux	intent:can_i_get_from_feces_animal_pets
toucher des oeufs de poules est-il risqué	intent:can_i_get_from_feces_animal_pets
aller à la chasse d'animaux sauvages est-il dangereux	intent:can_i_get_from_feces_animal_pets
puis-je transmettre le coronavirus à ma tortue	intent:can_i_get_from_feces_animal_pets
animal origine coronavirus	intent:can_i_get_from_feces_animal_pets
mon cheval peut-il avoir le virus	intent:can_i_get_from_feces_animal_pets
je dois me débarrasser des oiseaux	intent:can_i_get_from_feces_animal_pets
je dois laver mon chien régulièrement	intent:can_i_get_from_feces_animal_pets
mon chat peut avoir le coronavirus	intent:can_i_get_from_feces_animal_pets
puis-je être contaminée avec une piqûre de moustique	intent:can_i_get_from_feces_animal_pets
risque de contamination en mangeant du poisson cru	intent:can_i_get_from_feces_animal_pets
contracter le covid-19 par les animaux de compagnie	intent:can_i_get_from_feces_animal_pets
est-ce possible de contracter le coronavirus par mon animal de compagnie	intent:can_i_get_from_feces_animal_pets
le coronavirus est-il dangereux pour les animaux	intent:can_i_get_from_feces_animal_pets
ma poule peut-elle être contaminée	intent:can_i_get_from_feces_animal_pets
informations sur le risque de contamination pour les animaux	intent:can_i_get_from_feces_animal_pets
coronavirus poisson rouge	intent:can_i_get_from_feces_animal_pets
les oeufs peuvent-ils être contaminés	intent:can_i_get_from_feces_animal_pets
comment savoir si mon chat a le coronavirus	intent:can_i_get_from_feces_animal_pets
mon perroquet peut-il attraper le coronavirus	intent:can_i_get_from_feces_animal_pets
chat angora transmission virus	intent:can_i_get_from_feces_animal_pets
est-ce que les araignées transmettent le virus	intent:can_i_get_from_feces_animal_pets
cuisson viande de boeuf coronavirus	intent:can_i_get_from_feces_animal_pets
bave de chien contamination	intent:can_i_get_from_feces_animal_pets
transmission du coronavirus par les animaux	intent:can_i_get_from_feces_animal_pets
mon animal de compagnie peut-il attraper le virus	intent:can_i_get_from_feces_animal_pets
puis-je être contaminée si je mange de la viande exotique	intent:can_i_get_from_feces_animal_pets
dois-je éviter de toucher mon chien si j'ai le coronavirus	intent:can_i_get_from_feces_animal_pets
les chauves-souris transmettent-elles le coronavirus	intent:can_i_get_from_feces_animal_pets
espèces d'animaux pouvant contracter le coronavirus	intent:can_i_get_from_feces_animal_pets
les chats transmettent-ils le corona	intent:can_i_get_from_feces_animal_pets
puis-je être contaminé si je touche l'herbe où un chien est passé	intent:can_i_get_from_feces_animal_pets
mon chien peut-il infecter mon chat	intent:can_i_get_from_feces_animal_pets
dans quelle viande se trouve le covid-19	intent:can_i_get_from_feces_animal_pets
a quelle température cuire la viande pour éliminer le virus	intent:can_i_get_from_feces_animal_pets
mon chat peut-il attraper le corona	intent:can_i_get_from_feces_animal_pets
ma tortue est-elle en sécurité si j'ai le corona	intent:can_i_get_from_feces_animal_pets
les oiseaux tranportent-ils le corona	intent:can_i_get_from_feces_animal_pets
est-ce que les coccinelles donnent le corona	intent:can_i_get_from_feces_animal_pets
le covid-19 est-il transmissible aux animaux de compagnie	intent:can_i_get_from_feces_animal_pets
animaux qui peuvent avoir le coronavirus	intent:can_i_get_from_feces_animal_pets
est-ce que le coronavirus peut être dans la viande qu'on mange	intent:can_i_get_from_feces_animal_pets
coronavirus dans les poils de chat et chien	intent:can_i_get_from_feces_animal_pets
est-ce que mon animal peut attraper le covid-19 en léchant une surface infectée	intent:can_i_get_from_feces_animal_pets
est-ce que les insectes peuvent transporter le coronavirus	intent:can_i_get_from_feces_animal_pets
chat coronavirus belgique	intent:can_i_get_from_feces_animal_pets
si je suis malade quel est le risque de contaminer mon chat	intent:can_i_get_from_feces_animal_pets
les animaux sont-ils immunes contre le coronavirus	intent:can_i_get_from_feces_animal_pets
la transmission du corona virus entre animaux est-elle avérée	intent:can_i_get_from_feces_animal_pets
est-ce vrai que le covid 19 vient d'une souche animale	intent:can_i_get_from_feces_animal_pets
les animaux développent-ils des symptômes du covid 19 similaires aux êtres humains	intent:can_i_get_from_feces_animal_pets
est-il vrai que les animaux ont une immunité au covid 19 bien supérieure à celle de l'humain	intent:can_i_get_from_feces_animal_pets
un animal peut-il attraper le virus et le transmettre sans symptômes	intent:can_i_get_from_feces_animal_pets
vrai : cas de chats positifs covid 19 sans contact humain	intent:can_i_get_from_feces_animal_pets
les chauves-souris sont-elles vraiment à blâmer de la contamination de l'être humain par le covid 19	intent:can_i_get_from_feces_animal_pets
quel animal est dit être intermédiaire de la transmission du coronavirus depuis les chauves-souris	intent:can_i_get_from_feces_animal_pets
les animaux domestiques doivent-ils être confinés	intent:can_i_get_from_feces_animal_pets
quels animaux peuvent être affectés par le coronavirus	intent:can_i_get_from_feces_animal_pets
le virus est-il transmissible de l'animal vers l'homme	intent:can_i_get_from_feces_animal_pets
lien entre pangolin et origine du coronavirus	intent:can_i_get_from_feces_animal_pets
les animaux sont-ils des facteurs de propagation	intent:can_i_get_from_feces_animal_pets
quelles précautions à prendre pour mon chat	intent:can_i_get_from_feces_animal_pets
quels animaux sont suspectés d'être à l'origine de la transmission inter-espèces du virus	intent:can_i_get_from_feces_animal_pets
coronavirus et animaux de compagnie	intent:can_i_get_from_feces_animal_pets
les rongeurs peuvent-ils transmettre la maladie de covid	intent:can_i_get_from_feces_animal_pets
quels animaux sont supposés transmettre le coronavirus	intent:can_i_get_from_feces_animal_pets
est-ce que les poules peuvent transmettre le coronavirus	intent:can_i_get_from_feces_animal_pets
quelle est la de vie du coronavirus sur les chaussures	intent:can_i_get_from_packages_surfaces
il vit combien de temps sur le siège d'un bus	intent:can_i_get_from_packages_surfaces
coronavirus surfaces métalliques	intent:can_i_get_from_packages_surfaces
sur les végétaux, est-ce qu'il survit longtemps	intent:can_i_get_from_packages_surfaces
combien de temps vit le coronavirus sur une monnaies métallique	intent:can_i_get_from_packages_surfaces
combien de temps survit le coronavirus sur une surface congelée	intent:can_i_get_from_packages_surfaces
surface chauffée par le soleil, durée de vie, corona	intent:can_i_get_from_packages_surfaces
infos coronavirus vêtements	intent:can_i_get_from_packages_surfaces
combien de temps ça reste sur le bois	intent:can_i_get_from_packages_surfaces
cherche la contamination sur les surfaces	intent:can_i_get_from_packages_surfaces
là ça peut se propager sur le métal	intent:can_i_get_from_packages_surfaces
covid 19 temps d’existence surfaces	intent:can_i_get_from_packages_surfaces
dis-moi moi si je dois changer mes fringues	intent:can_i_get_from_packages_surfaces
faut-il désinfecter les canapés	intent:can_i_get_from_packages_surfaces
durée de vie du virus sur les fruits et légumes	intent:can_i_get_from_packages_surfaces
risque de contamination si je reçois un colis	intent:can_i_get_from_packages_surfaces
comment de temps survit le virus sur du carton	intent:can_i_get_from_packages_surfaces
comment de temps survit le virus sur du plastique	intent:can_i_get_from_packages_surfaces
sur quelles surfaces peut survivre le covid-19	intent:can_i_get_from_packages_surfaces
durée de vie du virus sur mes courses	intent:can_i_get_from_packages_surfaces
le coronavirus résiste-il au froid	intent:can_i_get_from_packages_surfaces
à quelle température meurt le coronavirus	intent:can_i_get_from_packages_surfaces
coronavirus ticket de caisse	intent:can_i_get_from_packages_surfaces
est-ce qu'il peut y avoir du virus sur un savon	intent:can_i_get_from_packages_surfaces
combien de temps est-ce que le coronavirus reste sur un stylo	intent:can_i_get_from_packages_surfaces
comment savoir si une surface est contaminée	intent:can_i_get_from_packages_surfaces
est-ce que le coronavirus peut rester sur mon sac à main	intent:can_i_get_from_packages_surfaces
coronavirus oreiller	intent:can_i_get_from_packages_surfaces
le coronavirus peut-il survivre sur mes vêtements	intent:can_i_get_from_packages_surfaces
coronavirus surfaces supermarché	intent:can_i_get_from_packages_surfaces
survie coronavirus métal	intent:can_i_get_from_packages_surfaces
est-ce que je peux tuer le virus en mettant mes vêtements au soleil pendant quelques heures	intent:can_i_get_from_packages_surfaces
coronavirus transmission neige	intent:can_i_get_from_packages_surfaces
corona propagation bijoux	intent:can_i_get_from_packages_surfaces
combien de temps survit le coronavirus sur une bouteille en plastique	intent:can_i_get_from_packages_surfaces
est-ce que je peux attraper le covid-19 à cause de mon smartphone	intent:can_i_get_from_packages_surfaces
le virus peut-il être présent sur la cuvette des toilettes	intent:can_i_get_from_packages_surfaces
le journal peut donner le corona	intent:can_i_get_from_packages_surfaces
est-ce que mon colis est sûr	intent:can_i_get_from_packages_surfaces
le coronavirus reste combien de temps sur le métal	intent:can_i_get_from_packages_surfaces
dois-je laisser mes chaussures dehors	intent:can_i_get_from_packages_surfaces
le covid-19 est-il sur le volant	intent:can_i_get_from_packages_surfaces
durée de vie coronavirus sur surfaces inertes	intent:can_i_get_from_packages_surfaces
le coronavirus vit combien de temps sur le plastique	intent:can_i_get_from_packages_surfaces
transmission coronavirus surfaces inertes	intent:can_i_get_from_packages_surfaces
combien d'heures peut survivre le coronavirus sur les surfaces	intent:can_i_get_from_packages_surfaces
est-ce que le coronavirus peut rester vivant sur la monnaie et les billets	intent:can_i_get_from_packages_surfaces
sur quels types de surfaces le coronavirus survit le plus longtemps	intent:can_i_get_from_packages_surfaces
je peux attraper le coronavirus en manipulant de l'argent liquide	intent:can_i_get_from_packages_surfaces
pour combien de temps le virus reste-il actif sur une surface de carton	intent:can_i_get_from_packages_surfaces
un emballage en plastique touché par un porteur du virus est-il forcément contaminé	intent:can_i_get_from_packages_surfaces
les gants en silicone chopent-ils le virus	intent:can_i_get_from_packages_surfaces
le virus disparait-il des fruits et légumes contaminés après cuisson	intent:can_i_get_from_packages_surfaces
les poignées de portes et les boutons d'ascenseur en métal sont-ils sources de contamination par le virus	intent:can_i_get_from_packages_surfaces
l'exposition des surfaces au soleil facilite-t-elle l'élimination du virus	intent:can_i_get_from_packages_surfaces
le virus filtré par un masque y reste-t-il actif pour longtemps	intent:can_i_get_from_packages_surfaces
les surblouses peuvent-elles être réutilisées après une période données suite à laquelle le virus deviendrait inactif	intent:can_i_get_from_packages_surfaces
combien de temps le virus survit-il à l'air libre	intent:can_i_get_from_packages_surfaces
est-ce que je peux encore commander des colis malgré la pandémie	intent:can_i_get_from_packages_surfaces
durée de vie covid19 matières plastiques	intent:can_i_get_from_packages_surfaces
risque contamination smartphone	intent:can_i_get_from_packages_surfaces
transmission coronavirus poignée de porte	intent:can_i_get_from_packages_surfaces
le coronavirus peut survivre le plus longtemps sur quel type de surfaces	intent:can_i_get_from_packages_surfaces
quel est le risque de contamination par le coronavirus si on touche un mouchoir usagé	intent:can_i_get_from_packages_surfaces
coronavirus et propagation via linge de maison	intent:can_i_get_from_packages_surfaces
le coronavirus survit-il sur un produit surgelé	intent:can_i_get_from_packages_surfaces
peut-on être contaminé par le codid-19 en touchant les cheveux d'une personne malade	intent:can_i_get_from_packages_surfaces
coronavirus et volant de voiture	intent:can_i_get_from_packages_surfaces
quel est le risque d'être contaminé par le coronavirus via le courrier	intent:can_i_get_from_packages_surfaces
région la plus risquée en europe	intent:what_if_i_visited_high_risk_area
liste des pays à haut risque europe	intent:what_if_i_visited_high_risk_area
puis-je voyager vers un pays à haut risque	intent:what_if_i_visited_high_risk_area
quel est le protocole de rapatriement depuis un pays à haut risque	intent:what_if_i_visited_high_risk_area
la chine est-elle toujours considérée haut risque	intent:what_if_i_visited_high_risk_area
puis-je aller en chine déjà ou bien c'est risqué	intent:what_if_i_visited_high_risk_area
trouve-moi les zones à haut risque	intent:what_if_i_visited_high_risk_area
suis-je dans un pays à haut risque	intent:what_if_i_visited_high_risk_area
c’est quoi une zone à haut risque	intent:what_if_i_visited_high_risk_area
est-ce que la chine est toujours à risque	intent:what_if_i_visited_high_risk_area
dans quelles régions il faut pas aller	intent:what_if_i_visited_high_risk_area
où dans le monde y a-t-il le moins de risques	intent:what_if_i_visited_high_risk_area
tu peux me chercher les continents à risque	intent:what_if_i_visited_high_risk_area
que faire si je reviens d'une zone à risques	intent:what_if_i_visited_high_risk_area
quels sont les endroits à risque	intent:what_if_i_visited_high_risk_area
donne-moi les zones à éviter pour le covid-19	intent:what_if_i_visited_high_risk_area
que faire si j'ai été en chine	intent:what_if_i_visited_high_risk_area
liste des pays les plus touchés par le corona	intent:what_if_i_visited_high_risk_area
combien de temps doit durer la quarantaine après être revenu d'un pays à risques	intent:what_if_i_visited_high_risk_area
informations sur les pays à haut risque	intent:what_if_i_visited_high_risk_area
renseigne-moi sur les pays à éviter par rapport au covid-19	intent:what_if_i_visited_high_risk_area
zones à risque covid19	intent:what_if_i_visited_high_risk_area
que faire si je viens de visiter l'oise	intent:what_if_i_visited_high_risk_area
protocole de test de dépistage au retour des états-unis	intent:what_if_i_visited_high_risk_area
suis-je autorisé à voyager depuis une zone à haut risque	intent:what_if_i_visited_high_risk_area
liste de zones à risque covid19	intent:what_if_i_visited_high_risk_area
dérogation rapatriement depuis zone à risque	intent:what_if_i_visited_high_risk_area
donner tous les pays à haut risque	intent:what_if_i_visited_high_risk_area
comment me protéger du virus si je vais aux états-unis	intent:what_if_i_visited_high_risk_area
précautions de voyage zone à haut risque	intent:what_if_i_visited_high_risk_area
temps d'isolement après visite zone haut risque	intent:what_if_i_visited_high_risk_area
faire une liste de toutes les zones à haut risque aux état-unis	intent:what_if_i_visited_high_risk_area
est-ce que j'aurai un suivi médical après mon voyage dans une zone à haut risque	intent:what_if_i_visited_high_risk_area
quelles précautions je prends si je viens d'une zone à haut risque	intent:what_if_i_visited_high_risk_area
quelles sont les zones à haut risque	intent:what_if_i_visited_high_risk_area
comment je me protège si je suis dans une zone à haut risque	intent:what_if_i_visited_high_risk_area
liste zones à haut risque	intent:what_if_i_visited_high_risk_area
mise à jour zone à haut risque	intent:what_if_i_visited_high_risk_area
classement zones à haut risque	intent:what_if_i_visited_high_risk_area
protection dans pays à haut risque	intent:what_if_i_visited_high_risk_area
comment quitter une zone à haut risque	intent:what_if_i_visited_high_risk_area
quelles sont les zones à haut risque actuellement	intent:what_if_i_visited_high_risk_area
liste zones considérées à haut risque	intent:what_if_i_visited_high_risk_area
qu'est-ce que je dois faire si je suis allée récemment dans une zone à fort taux de contamination	intent:what_if_i_visited_high_risk_area
comment être rapatrié dans son pays quand on est dans une zone à risque	intent:what_if_i_visited_high_risk_area
conseils pour voyageurs zones à haut risque	intent:what_if_i_visited_high_risk_area
je vais être mise en quarantaine si je reviens d'un pays à haut risque	intent:what_if_i_visited_high_risk_area
rapatriement d'une zone à haut risque coronavirus	intent:what_if_i_visited_high_risk_area
procédure quand on revient d'une zone à haut risque	intent:what_if_i_visited_high_risk_area
dis-moi quelles sont les zones à haut risque maintenant	intent:what_if_i_visited_high_risk_area
quels sont les pays considérés comme étant à haut risque sanitaire en raison du covid 19	intent:what_if_i_visited_high_risk_area
quelles sont les consignes à suivre lors du retour d'un pays particulièrement touché par le covid 19	intent:what_if_i_visited_high_risk_area
comment me déclarer aux autorités pour un rapatriement d'une zone à risque	intent:what_if_i_visited_high_risk_area
dois-je observer un confinement individuel à l'hôtel ou rentrer chez moi au retour d'un pays où la pandémie covid 19 est très répandue	intent:what_if_i_visited_high_risk_area
au retour d'une zone particulièrement touchée comme la belgique, l'etat prendra-il en charge les frais de confinement à l'hôtel pour mieux préserver la famille	intent:what_if_i_visited_high_risk_area
j'ai été testé négatif au covid 19 deux jours avant mon retour de turquie, dois-je quand même me confiner chez moi	intent:what_if_i_visited_high_risk_area
paris et mulhouse sont-elles des zones à haut risque sanitaire en france	intent:what_if_i_visited_high_risk_area
dois-je me faire dépister au retour d'italie même si je n'ai pas eu de symptômes de covid 19	intent:what_if_i_visited_high_risk_area
quels sont les pays les plus risqués avec le covid 19	intent:what_if_i_visited_high_risk_area
liste récente des zones coronavirus à haut risque	intent:what_if_i_visited_high_risk_area
je reviens d'italie, que dois-je faire	intent:what_if_i_visited_high_risk_area
où a-t-on le plus de risque d'attraper le coronavirus	intent:what_if_i_visited_high_risk_area
zones à haut -risque en bretagne	intent:what_if_i_visited_high_risk_area
quels pays éviter corona	intent:what_if_i_visited_high_risk_area
dois-je m'inquiéter si j'ai visité l'italie	intent:what_if_i_visited_high_risk_area
quelles sont les zones à haut risque de coronavirus	intent:what_if_i_visited_high_risk_area
carte des pays à haut risque	intent:what_if_i_visited_high_risk_area
liste des pays à risque corona	intent:what_if_i_visited_high_risk_area
carte des pays à risque corona	intent:what_if_i_visited_high_risk_area
liste pays à risque covid-19	intent:what_if_i_visited_high_risk_area
carte pays à risque covid-19	intent:what_if_i_visited_high_risk_area
quelle est la durée des traitements pour soigner le coronavirus	intent:what_are_treatment_options
comment traiter le coronavirus	intent:what_are_treatment_options
efficacité chloroquine coronavirus	intent:what_are_treatment_options
comment accélerer la guérison du virus	intent:what_are_treatment_options
médicaments à prendre symptômes covid-19	intent:what_are_treatment_options
la chloroquine est-elle efficace contre le coronavirus	intent:what_are_treatment_options
trithérapie covid-19	intent:what_are_treatment_options
faut-il prendre de la vitamine c si on est contaminé	intent:what_are_treatment_options
quel est le protocole de soins pour le corona	intent:what_are_treatment_options
le bicarbonate de soude marche peut)il tuer le virus	intent:what_are_treatment_options
traitement vitamine c coronavirus	intent:what_are_treatment_options
comment gérer les symptômes du coronavirus de façon naturelle	intent:what_are_treatment_options
comment apaiser la toux de façon naturelle	intent:what_are_treatment_options
est-ce que la codéine est efficace contre la toux provoquée par le corona	intent:what_are_treatment_options
traitement le plus efficace contre le coronavirus	intent:what_are_treatment_options
processus médical covid19	intent:what_are_treatment_options
hydroxychloroquine et coronavirus	intent:what_are_treatment_options
quand un vaccin sera--t-il disponible contre le covid19	intent:what_are_treatment_options
guérison médicamenteuse coronavirus	intent:what_are_treatment_options
quels sont les antibiotiques plus ou moins efficaces contre le coronavirus	intent:what_are_treatment_options
quel traitement pour un enfant atteint par le covid-19	intent:what_are_treatment_options
y a-t-il des personnes guéries du covid-19 suite à un traitement médicamenteux	intent:what_are_treatment_options
existe-t-il des médicaments préconisés en cas de covid-19	intent:what_are_treatment_options
la vitamine c peut-elle aider à prévenir le covid-19	intent:what_are_treatment_options
antihistaminiques et covid-19	intent:what_are_treatment_options
le paracétamol est-il efficace quand on a le covid	intent:what_are_treatment_options
indique-moi des traitements contre le coronavirus s'il te plaît	intent:what_are_treatment_options
y a-t-il des médicament pour se protéger du virus	intent:what_are_treatment_options
comment guérir du covid-19	intent:what_are_treatment_options
remèdes maison corona	intent:what_are_treatment_options
renseignements vaccin covid-19	intent:what_are_treatment_options
est-ce que le vaccin contre la grippe marche	intent:what_are_treatment_options
chercher traitement covid 19	intent:what_are_treatment_options
dis-moi comment je peux me soigner	intent:what_are_treatment_options
y a-t-il des traitements pour les enfants	intent:what_are_treatment_options
comment aider les vieux à guérir	intent:what_are_treatment_options
infos vaccins en cours coronavirus	intent:what_are_treatment_options
vaccins commencés chercheurs	intent:what_are_treatment_options
professeur didier raoult	intent:what_are_treatment_options
azithromycine et coronavirus -efficacité du traitement	intent:what_are_treatment_options
pourquoi l’ibuprofène est-il déconseillé pour le traitement du coronavirus	intent:what_are_treatment_options
existe-t-il des traitements efficaces contre le coronavirus	intent:what_are_treatment_options
la vaccination contre la grippe immunise-t-elle du coronavirus	intent:what_are_treatment_options
où en est-on dans la recherche d'un vaccin	intent:what_are_treatment_options
en quoi consiste l'essai clinique portant sur le plasma de patients guéris	intent:what_are_treatment_options
pourquoi la chloroquine et l'hydroxychloroquine font-ils autant polémique	intent:what_are_treatment_options
coronavirus et homéopathie	intent:what_are_treatment_options
est-ce que le traitement du professeur raoult marche	intent:what_are_treatment_options
les recherches sur la chloroquine ça donne quoi	intent:what_are_treatment_options
coronavirus anti-inflammatoires déconseillés pourquoi	intent:what_are_treatment_options
covid-19 traitement plasma sanguin	intent:what_are_treatment_options
doit-on croire le professeur raoult	intent:what_are_treatment_options
quels médicaments prendre si on a le coronavirus	intent:what_are_treatment_options
remèdes covid-19	intent:what_are_treatment_options
remèdes de grand-mère coronavirus	intent:what_are_treatment_options
traitements possibles corona	intent:what_are_treatment_options
traitements possibles covid-19	intent:what_are_treatment_options
quand sera prêt le vaccin pour corona	intent:what_are_treatment_options
quels antibiotiques contre covid-19	intent:what_are_treatment_options
soigner corona avec homéopathie	intent:what_are_treatment_options
quelles sont les idées fausses sur le covid-19	intent:myths
mythe du citron pour soigner le corona	intent:myths
quels sont les mythes les plus dangereux sur le coronavirus	intent:myths
les femmes moins touchées que les hommes c'est un concept contrefait	intent:myths
mythe de l'oignon coupé en deux	intent:myths
mythes corona à éviter	intent:myths
l'immunisation de masse mythe ou non	intent:myths
chiffres décès truqués chine	intent:myths
mythes les plus courants sur le covid19	intent:myths
théorie du complot chine coronavirus	intent:myths
manipulation des chiffres des décès en chine	intent:myths
quels mythes sur le coronavirus ont été réfutés	intent:myths
résumé des fausses informations autour du covid19	intent:myths
principaux mythes autour du covid19	intent:myths
quels sont les mythes les plus répandus sur le coronavirus en ce moment	intent:myths
mythe coronavirus créé par les russes	intent:myths
mythe coronavirus arme biologique	intent:myths
quelles sont les théories conspirationnistes autour du coronavirus	intent:myths
coronavirus et théories du complot	intent:myths
les mythes les plus fous concernant le coronavirus	intent:myths
la création du coronavirus dans un laboratoire est-ce un mythe	intent:myths
donne-moi les mythes les plus populaires sur le coronavirus	intent:myths
intox coronavirus	intent:myths
est-ce vrai que le virus est plus dangereux pour les personnes âgées	intent:myths
est-ce vrai que les enfants ne sont pas malades	intent:myths
falsification des statisques en chine	intent:myths
est-ce que s'exposer au soleil empêche de contracter le covid-19	intent:myths
est-ce vrai que l'institut pasteur a breveté un vaccin pour le coronavirus en 2004	intent:myths
est-ce une fake news que le virus survit 2 jours	intent:myths
combien de bières il faut boire pour guérir	intent:myths
coronavirus race la plus résistante	intent:myths
bière corona pour guérir virus corona	intent:myths
le virus peut circuler dans les pays chauds	intent:myths
est-ce que fumer peut tuer le covid 19	intent:myths
qui a fabriqué le coronavirus aux us	intent:myths
c'est quoi les mythes sur le virus	intent:myths
c'est vrai que le virus a été concu en laboratoire	intent:myths
les rumeurs sur le coronavirus sont-elles vraies	intent:myths
ce mythe de l'eau de javel est-il vrai	intent:myths
l'usage du bicarbonate de soude contre le virus est-il recommandé	intent:myths
le virus est-il un hoax	intent:myths
est-ce un mythe de die que le virus est une simple grippe	intent:myths
l'inde est-elle immunisée contre le virus	intent:myths
les personnes jeunes ne peuvent pas être affectées	intent:myths
le coronavirus n'est dangereux que chez les personnes âgées souffrant de conditions préexistantes	intent:myths
la consommation d'ail prémunit contre le sars-cov-2	intent:myths
mythe ou réalité - essayer d'attraper le coronavirus pour devenir immunisé et incapable d'infecter ses parents à l'avenir	intent:myths
les moustiques transmettent le covid-19	intent:myths
prendre un bain empêche d’attraper le coronavirus	intent:myths
les fumeurs n’attrapent pas le coronavirus –vrai ou faux	intent:myths
la technologie 5g est liée à la propagation du coronavirus	intent:myths
le covid 19 n'a fait que des victimes adultes	intent:myths
les anticorps développés par une personne suite à une atteinte du covid 19 l'immunisent pour une période de deux ans	intent:myths
la mère enceinte peut transmettre le corona virus à son fœtus : vrai	intent:myths
certains aliments boostent le système immunitaire pour mieux combattre le corona virus en cas d'atteinte	intent:myths
le gingembre est efficace contre le covid 19 : mythe ou réalité	intent:myths
est-il vrai que le covid 19 serait issu de la manipulation du code génétique d'un virus sars croisé avec celui du sida	intent:myths
le covid 19 a-t-il été développé dans un laboratoire chinois afin de nuire à l'occident	intent:myths
mythes les plus populaires covid-19	intent:myths
mythe coronavirus causé par bill gates et les antennes 5g	intent:myths
mythe chine qui cache des informations covid-19	intent:myths
manger des pangolins chine mythe	intent:myths
mythes remèdes contre le coronavirus	intent:myths
mythes vaccins corona	intent:myths
le coronavirus est un type de grippe mythe	intent:myths
mythes discrédités corona	intent:myths
vérité sur les mythes du coronavirus	intent:myths
infos fake sur coronavirus	intent:myths
infos fake sur covid-19	intent:myths
hoax sur le coronavirus	intent:myths
théories du complot coronavirus	intent:myths
quelles infos sur corona sont fausses	intent:myths
lien entre 5g et coronavirus	intent:myths
ondes 5g corona	intent:myths
corona contrôle de la population	intent:myths
définir voyages essentiels	intent:travel
le co-voiturage est-il dangereux	intent:travel
moyen de transport le moins risqué corona	intent:travel
risques voyage par bateau coronavirus	intent:travel
vols annulés entre les provinces du canada ou pas	intent:travel
quelles sont les restrictions de voyage en europe à cause du coronavirus	intent:travel
c'est dangereux de prendre le métro	intent:travel
l'aéroport de roissy est-il ouvert	intent:travel
où est-ce que je peux voyager actuellement	intent:travel
les bus dans ma ville fonctionnent-ils	intent:travel
suis-je en danger si je prends un taxi	intent:travel
comment voyager pour cancun	intent:travel
où trouver un vol pour les maldives	intent:travel
pourrais-je prendre le tramway pour aller au travail	intent:travel
conseils déplacements pendant l'épidémie	intent:travel
puis-je encore circuler en europe pour raisons médicales	intent:travel
peut-on prendre l'avion depuis un pays à risque	intent:travel
annulation trajet non-essentiel	intent:travel
quels moyens de transport sont-ils toujours assurés pendant l'épidémie	intent:travel
quels trajets sont-ils considérés comme essentiels	intent:travel
les vols domestiques en france sont-ils maintenus pendant l'épidémie de covid-19	intent:travel
coronavirus moyens de transport à privilégier	intent:travel
mode de transport à éviter lors de la pandémie	intent:travel
quelle protection contre le coronavirus lorsqu'on doit voyager	intent:travel
coronavirus annuler un voyage	intent:travel
peut-on annuler un billet d'avion à cause du covid-19	intent:travel
pourquoi on a du mal à voyager	intent:travel
meilleur moyen de déplacement covid	intent:travel
le coronavirus et les conseils de voyage	intent:travel
quoi prendre entre le bus et le train	intent:travel
transports publics menace covid 19	intent:travel
cherche un taxi sans coronavirus	intent:travel
les pays déconseillés pour voyager	intent:travel
puis-je passer la frontière espagnole en voiture	intent:travel
les hotels de barcelone seront-ils ouverts en août	intent:travel
la russie a fermé ses frontières jusqu'à quand	intent:travel
puis-je rendre visite à ma grand-mère à calais la semaine prochaine	intent:travel
est-ce que je peux sortir du pays	intent:travel
je pourrai partir en australie quand	intent:travel
puis-je voyager si j'ai deja eu le virus	intent:travel
les hôtels de la grande motte sont-ils fermés	intent:travel
dans quel pays je pourrais voyager sans danger cet été	intent:travel
le voyage sera-t-il permis au mois de juillet	intent:travel
est-ce que je peux attraper le covid-19 dans l’avion	intent:travel
quels sont les moyens de prévention antivirus pendant un voyage	intent:travel
comment voyager sans risque d’attraper le virus	intent:travel
quels sont mes droits en cas de voyage annulé à cause du covid-19	intent:travel
peut-on toujours voyager en chine	intent:travel
comment le coronavirus peut impacter mes prochains voyages	intent:travel
quand pourrai-je voyager	intent:travel
conseils voyage covid-19	intent:travel
pays à éviter pendant la pandémie	intent:travel
voyages en avion possibles	intent:travel
quand pourrai-je aller en italie	intent:travel
est-ce que je dois me mettre en quarantaine si je voyage en europe	intent:travel
quels sont les règles d’hygiène et de sécurité que je dois respecter pour voyager en avion	intent:travel
y a-t-il des risques que mon vol vers londres soit annulé	intent:travel
vol ou train pour aller à marseille	intent:travel
transport le plus dangereux	intent:travel
voyages autorisés pendant le confinement	intent:travel
peut-on voyager pour rendre visite à de la famille malade	intent:travel
j'ai le droit de rentrer en france	intent:travel
est-ce que je peux voyager si je suis seul dans ma voiture	intent:travel
kit voyage coronavirus voyage en inde	intent:travel
puis-je louer une maison à la montagne en italie dans 2 jours	intent:travel
puis-je prendre l'avion en juillet	intent:travel
vers quels pays puis-je prendre le train	intent:travel
y'a-t-il des vols ouverts en europe	intent:travel
dois-je annuler mon vol en italie la semaine prochaine	intent:travel
kit voyage coronavirus voyage en inde	intent:travel
est-ce que les trams circulent normalement à lyon	intent:travel
dernières nouvelles coronavirus en afrique	intent:news_and_press
communiqué de presse coronavirus aujourd'hui	intent:news_and_press
infos corona ile-de-france	intent:news_and_press
puis-je avoir accès au dernier communiqué de presse concernant le covid19 en europe	intent:news_and_press
actualités corona allemagne	intent:news_and_press
peux-tu me transmettres les dernières infos disponibles sur le corona	intent:news_and_press
communiqué de presse gestion du coronavirus en angleterre	intent:news_and_press
que dit le point de presse de l'agence de santé pour la france aujourd'hui	intent:news_and_press
actualité covid-19 russie	intent:news_and_press
peux-tu me donner les mises à jour pour l'italie	intent:news_and_press
communiqué de presse canada	intent:news_and_press
quelles sont les nouvelles pour l'iran aujourd'hui	intent:news_and_press
quoi de neuf	intent:news_and_press
nouvelles infos	intent:news_and_press
que dit le communiqué de presse aujoud'hui	intent:news_and_press
mise à jour angleterre	intent:news_and_press
dernières nouvelles afp sur le coronavirus	intent:news_and_press
quelles sont les mises à jour récentes des mesures sanitaires aux états-unis	intent:news_and_press
où en est l'actualité de l'épidémie à singapour	intent:news_and_press
résumé du dernier communiqué de presse sur la situation sanitaire	intent:news_and_press
quelles sont les nouvelles informations sur le coronavirus	intent:news_and_press
quelles nouvelles mesures ont été prises en italie	intent:news_and_press
nouvelles de la pandémie en amérique du sud	intent:news_and_press
quoi de neuf au sujet de la pandémie de covid-19	intent:news_and_press
quelles sont les actualités sur le covid-19 en europe	intent:news_and_press
infos covid-19 le monde	intent:news_and_press
je veux connaitre les actualités sur le covid-19	intent:news_and_press
dernières actualités sur le covid en france	intent:news_and_press
communiqué de presse de l’oms	intent:news_and_press
fil d’actualités sur le coronavirus	intent:news_and_press
infos nouveau corona en direct	intent:news_and_press
tu as quoi comme actus sur le virus	intent:news_and_press
lis-moi toutes les dernières infos	intent:news_and_press
tu as des nouvelles depuis hier soir	intent:news_and_press
la presse sur le covid 19 en iran	intent:news_and_press
ca dit quoi les nouvelles ce matin sur le corona	intent:news_and_press
qu'est ec qui s'est passé dans les médias	intent:news_and_press
les médias disent quoi du virus	intent:news_and_press
les nouvelles du corona, ça donne quoi	intent:news_and_press
il se passe quoi dans les news en allemagne	intent:news_and_press
il y a eu un communiqué de presse du premier ministre	intent:news_and_press
l'oms a t-elle émis un communiqué	intent:news_and_press
les infos disent quoi du corona	intent:news_and_press
dernières infos corona afp	intent:news_and_press
infos en temps réel covid-19	intent:news_and_press
mises à jour au sujet du corona	intent:news_and_press
dernières consignes au sujet du corona	intent:news_and_press
news du jour sur le covid-19	intent:news_and_press
nouvelles informations au sujet du coronavirus	intent:news_and_press
donne moi les dernières infos en temps réel	intent:news_and_press
covid-19 dernières infos	intent:news_and_press
infos les plus récents à propos de corona	intent:news_and_press
dernières actus sur le coronavirus au royaume-uni	intent:news_and_press
donne-moi les dernières infos sur le covid-19	intent:news_and_press
quelles infos ont été communiquées sur le déconfinement en france	intent:news_and_press
communiqués afp covid-19	intent:news_and_press
articles les plus récents publiés aujourd'hui sur le covid-19	intent:news_and_press
quelles sont les news sur le coronavirus	intent:news_and_press
dis-moi si j'ai raté des infos sur le coronavirus	intent:news_and_press
mises à jour covid-19	intent:news_and_press
que dit la presse sur le coronavirus	intent:news_and_press
dis-moi s’il y a des nouvelles infos	intent:news_and_press
tu me trouves les actus à la une	intent:news_and_press
communiqué sur les cas de coronavirus	intent:news_and_press
que peux-tu me dire de nouveau sur le covid	intent:news_and_press
dernières nouvelles sur le covid-19 en france	intent:news_and_press
actualités covid-19	intent:news_and_press
nouveau communiqué de presse concernant le covid-19 en france	intent:news_and_press
mises à jours quotidiennes covid-19	intent:news_and_press
veuillez me donner les dernières infos sur le coronavirus en chine	intent:news_and_press
peux-tu me communiquer l’actualité concernant le covid-19 en france	intent:news_and_press
est-ce qu’il y a des nouvelles sur le covid-19 en italie	intent:news_and_press
peux-tu me donner l’actualité covid-19 en espagne	intent:news_and_press
envoyer ce liens à tous mes contacts	intent:share
poster le lien de ce bot sur twitter	intent:share
partage le lien de ce bot à tous mes contacts whatsapp	intent:share
envoyer bot info corona à les contact	intent:share
partager ce lien en story instagram	intent:share
partage le lien de ce bot en story	intent:share
publie cette information sur reddit	intent:share
je voudrais partager tout ça sur twitter	intent:share
montre ça à mes amis	intent:share
envoie ce lien sur pinterest	intent:share
diffuse ce lien à mes contacts messenger	intent:share
peux-tu envoyer ce lien sur facebook	intent:share
partage cette information avec mes contacts whatsapp	intent:share
peux-tu partager ce contenu sur facebook	intent:share
je veux diffuser ça sur pinterest	intent:share
partage avec ma famille	intent:share
publie ce lien sur twitter	intent:share
prépare un tweet avec cet article	intent:share
partage ces articles sur facebook	intent:share
copie le contenu de cet article dans une publication facebook	intent:share
publie cette information sur facebook	intent:share
envoie ce lien à ma sœur	intent:share
envoie cet article à mes parents s'il te plait	intent:share
publie ça sur twitter stp	intent:share
est-ce que tu peux partager cette réponse sur mon mur	intent:share
puis-je partager avec mes contacts facebook	intent:share
j'aimerais partager tes services avec mes amis sur facebook	intent:share
comment pourrais-je partager ces infos	intent:share
je fais comment pour partager tes services avec mes amis	intent:share
partageons cela sur twitter	intent:share
et si on partageait cette info avec mes amis facebook	intent:share
comment dois-je faire pour partager tes infos avec quelqu'un	intent:share
il faut que je partage cela sur mon compte insta	intent:share
mes contacts ont besoin de ton aide	intent:share
il y a un lien que je peux partager	intent:share
partager ton lien au groupe	intent:share
tu peux fournir un lien pour les réseaux	intent:share
parle du bot sur facebook	intent:share
dis à mes amis d'utiliser le bot	intent:share
partage le bot sur facebook	intent:share
partage ce service sur ma page	intent:share
crée un post sur le bot	intent:share
le bot devrait être partagé	intent:share
poste sur le bot sur les reseaux	intent:share
poste le lien du bot	intent:share
partage ça sur le discord de jean	intent:share
partage le lien vers mon bot messenger	intent:share
publiez le lien sur facebook	intent:share
mes amis facebook doivent voir ce bot	intent:share
assurez-vous que tous mes amis peuvent voir ce lien	intent:share
partage le lien de ce bot avec tous mes amis fb	intent:share
partage le lien de ce bot docteur avec tous mes amis snap	intent:share
partage bot infos corona	intent:share
partage tes services avec mes amis proches	intent:share
partager services corona bot avec contacts	intent:share
partage ton lien de bot corona avec tout les contacts en story	intent:share
partage ce lien avec mes contacts	intent:share
peux-tu mettre ces résultats sur ma page twitter	intent:share
comment partager ce lien sur mes réseaux sociaux	intent:share
bot partagé avec mes amis	intent:share
vas-y partage ce lien sur la page facebook de mon mari	intent:share
je veux partager ce service	intent:share
coucou covid doc	intent:hi
bonjour docteur	intent:hi
hello doc covid	intent:hi
bonjour docteur corona	intent:hi
salut ça va	intent:hi
coucou toi	intent:hi
comment ça va doc covid	intent:hi
salut docteur covid	intent:hi
bonjour docteur corona	intent:hi
comment ça va docteur covid	intent:hi
salut doc covid	intent:hi
salut doc	intent:hi
comment vas-tu	intent:hi
comment ça va docteur bot	intent:hi
bonjour bot	intent:hi
hello hello bot	intent:hi
hey bot, ça va	intent:hi
bonjour docteur covid	intent:hi
bonjour cher docteur	intent:hi
hello toubib	intent:hi
salut doc corona	intent:hi
tout va bien docteur	intent:hi
quoi de neuf doc	intent:hi
hé doc corona	intent:hi
coucou mon toubib préféré	intent:hi
bonjour professeur corona	intent:hi
bonsoir expert corona	intent:hi
salut le nouveau scientifique	intent:hi
enchanté sa majesté corona	intent:hi
abracadabra corona	intent:hi
quoi de neuf docteur corona	intent:hi
hey le bot corona	intent:hi
salut coronadocteur	intent:hi
salut doc virus	intent:hi
info covid s'il te plait	intent:hi
coucou corona info service	intent:hi
coucou docteur corona	intent:hi
bonjour mon doc perso	intent:hi
ça va doc corona	intent:hi
es-tu là docteur	intent:hi
docteur corona au rapport	intent:hi
bonjour toubib	intent:hi
coucou doc corona, ça va	intent:hi
quoi de neuf docteur	intent:hi
bonsoir	intent:hi
hey	intent:hi
hey tu es là	intent:hi
salutations cher conseiller	intent:hi
salut mon pote le toubib	intent:hi
bonjour médecin virtuel	intent:hi
hello mon super docteur	intent:hi
salut docteur à domicile	intent:hi
bonjour, docteur sars-cov-2	intent:hi
comment allez-vous, docteur	intent:hi
hi, virus bot	intent:hi
coucou, mon cher docteur	intent:hi
corona toubib, comment ça va	intent:hi
hello bot, médecins contre covid	intent:hi
bonsoir, docteur	intent:hi
coucou corona, comment va le monde	intent:hi
coucou mon cher toubib	intent:hi
salut covid-19 info	intent:hi
hello, quoi de neuf	intent:hi
coucou coronavirus, t’es encore là	intent:hi
salut virus infos, il y a quelqu’un	intent:hi
bonjour mon doc	intent:hi
hello coronavirus infos	intent:hi
