sag mir bitte, wie viele menschen in deutschland gestorben sind	intent:latest_numbers
wie hoch ist die sterblichkeit bei corona in den usa	intent:latest_numbers
wie hoch schätzt man, ist die dunkelziffer an infizierten personen weltweit	intent:latest_numbers
wie viele corona infizierte in deutschland	intent:latest_numbers
wie viele leute, die über 60 jahre alt sind, sind an corona gestorben	intent:latest_numbers
zeig mir bitte,wie viele die coronainfizierte in deutschland gibt	intent:latest_numbers
aktuelle coronazahlen für deutschland	intent:latest_numbers
anzahl der toten durch corona weltweit	intent:latest_numbers
berichte über neue corona fälle in meinem landkreis	intent:latest_numbers
bitte gib mir die letzten fallzahlen aus deutschland	intent:latest_numbers
die aktuellen corona zahlen in bayern	intent:latest_numbers
die anzahl corona erkrankungen weltweit	intent:latest_numbers
die anzahl der infizierten in deutschland	intent:latest_numbers
die daten der gestorbenen in österreich	intent:latest_numbers
gebe mir bitte die jüngste statistik zum corona virus in deutschland	intent:latest_numbers
gib die aktuelle anzahl der infizierten an	intent:latest_numbers
gib mir aktuelle corona-zahlen für deutschland	intent:latest_numbers
gib mir bitte die fallzahlen in frankreich	intent:latest_numbers
gib mir die aktuellen zahlen zu corona	intent:latest_numbers
gib mir die anzahl an leuten die bereits in bayern infiziert sind	intent:latest_numbers
heutiger stand von corona in deutschland	intent:latest_numbers
ich brauche die letzte statistik von spanien	intent:latest_numbers
ich brauche updates der statistiken in den usa	intent:latest_numbers
ich möchte die corona statistik von österreich	intent:latest_numbers
ich will die neusten corona fälle in deutschland sehen	intent:latest_numbers
informiere mich über den aktuellen stand der coronaerkrankungen in deutschland	intent:latest_numbers
kannst du bitte mir die letzte aktuelle coronazahlen in der welt zeigen	intent:latest_numbers
nenn mir die anzahl der infizierten weltweit	intent:latest_numbers
nenne mir die aktuellen todeszahlen aus deutschland	intent:latest_numbers
nenne mir die fallzahlen in deutschland	intent:latest_numbers
nenne wir die aktuelle zahl der infizierten in deutschland	intent:latest_numbers
update über die anzahl der toten	intent:latest_numbers
was ist der aktuelle stand der statistiken über die todesraten für den coronavirus	intent:latest_numbers
was ist die aktuelle statistik von coronavirus in deutschland	intent:latest_numbers
was ist die zahl für gestobene in deutschland	intent:latest_numbers
was sind die aktuellen todeszahlen für deutschland	intent:latest_numbers
wie hoch ist die infiziertenzahl für corona in deutschland	intent:latest_numbers
wie hoch ist die sterberate in deutschland	intent:latest_numbers
wie ist die aktuelle lage der corona infizierten statistik hier in unna	intent:latest_numbers
wie ist die aktuelle reproduktionsrate in den usa	intent:latest_numbers
wie ist die aktuelle sterberate in deutschland durch corona	intent:latest_numbers
wie sieht die aktuelle statistik in dortmund bezüglich corona aus	intent:latest_numbers
wie sind die neuen fallzahlen in deutschland	intent:latest_numbers
wie viel leute sind am coronavirus gestorben	intent:latest_numbers
wie viele menschen sind weltweit vom corona-virus geheilt	intent:latest_numbers
wie viele personen haben corona virus in deutschland	intent:latest_numbers
wie viele personen sind in bayern infiziert	intent:latest_numbers
wie viel corona-tote gibt es momentan weltweit	intent:latest_numbers
wie viel infizierte gibt es aktuell in deutschland	intent:latest_numbers
wie viel prozent der bekannten corona-infizierten sind wieder gesund	intent:latest_numbers
wie viele corona-tote gibt es aktuell in bayern	intent:latest_numbers
wie viele menschen sind weltweit erkrankt	intent:latest_numbers
wie viele neue fälle sind seit gestern dazu gekommen	intent:latest_numbers
wie viele neuen fälle gab es gestern in offenbach	intent:latest_numbers
wie viele neuinfektionen in deutschland	intent:latest_numbers
wie viele todesfälle gibt es bisher in italien	intent:latest_numbers
zeig mir die aktuelle statistik zu corona in deutschland an	intent:latest_numbers
zeig mir die aktuellen weltweiten todeszahlen	intent:latest_numbers
zeig mir die neusten coronadaten	intent:latest_numbers
zeig mir die zahl der toten in deutschland von heute morgen	intent:latest_numbers
zeig mir die zahl der weltweiten corona toten	intent:latest_numbers
zeige mir die aktuellen zahlen in schweden	intent:latest_numbers
zeige mir die letzte statistik aus luxemburg	intent:latest_numbers
zeige mir die neuesten stastikenfür die welt auf	intent:latest_numbers
erzähle mir, wie ich mich vor einer ansteckung mit corona schützen kann	intent:protect_yourself
helfen desinfektionsmittel dabei, eine ansteckung mit dem virus zu verhindern	intent:protect_yourself
helfen gummihandschuhe dabei, eine ansteckung mit corona zu verhindern	intent:protect_yourself
helfen handschuhe dabei, eine ansteckung mit coronavirus zu vermeiden	intent:protect_yourself
hilft ein schal dabei, eine ansteckung mit dem coronavirus zu verhindern	intent:protect_yourself
hilft es gegen corona-viren, wenn ich im laden eine maske aufziehe	intent:protect_yourself
ich würde gerne wissen, wie gesichtsmasken zum schutz vor coronavirus beitragen	intent:protect_yourself
ist es sinnvoll, sich jetzt mit einer maske vor dem coronavirus zu schützen	intent:protect_yourself
kann man eine ansteckung sicher vermeiden, wenn man eine maske trägt	intent:protect_yourself
kannst du bitte mir zeigen, wie man sich gegen dem coronavirus schützen	intent:protect_yourself
macht es sinn, schutzmaßnahmen als schutz vor corona anzuwenden	intent:protect_yourself
man kann das coronavirus verbeugen, indem man öfters die hände wäscht und den kontakt mit menschen vermeidet	intent:protect_yourself
sag mir wie man es vermeidet, dass ältere menschen sich mit dem virus anstecken	intent:protect_yourself
schütze ich mich vor einer ansteckung mit dem coronavirus, wenn ich mir häufig die hände wasche	intent:protect_yourself
schutzmaßnahmen, um die ansteckung zu vermeiden	intent:protect_yourself
soll man vermeiden türklinken anzufassen, um sich vor corona zu schützen	intent:protect_yourself
tipps um die ansteckung mit corona zu vermeiden	intent:protect_yourself
was für maßnahmen kann man nehmen, um eine ansteckung mit dem coronavirus zu verhindern	intent:protect_yourself
was ist der beste schutz, um sich nicht mit dem virus anzustecken	intent:protect_yourself
was ist die beste methode, um mich vor einer corona-infektion zu schützen	intent:protect_yourself
was können besonders ältere menschen tun, um sich vor dem virus zu schützen	intent:protect_yourself
was kann ich tun, um mich vor corona zu schützen	intent:protect_yourself
was kann ich alles tun, um mich vor dem virus zu schützen	intent:protect_yourself
was kann ich tun, um das risiko einer ansteckung mit dem virus möglichst gering zu halten	intent:protect_yourself
was kann ich tun, um mich und andere vor covid-19 zu schützen	intent:protect_yourself
was man kann man tun, um sein baby vor dem coronavirus zu beschützen	intent:protect_yourself
was muss ich unternehmen, um nicht an covid zu erkranken	intent:protect_yourself
welche maßnahmen sollte man ergreifen, um eine ansteckung mit dem coronavirus zu vermeiden	intent:protect_yourself
welche sinnvollen vorkehrungen kann ich treffen, um mein kind vor einer infektion zu schützen	intent:protect_yourself
wie kann ich es vermeiden, dass ich mich mit dem coronavirus anstecke	intent:protect_yourself
wie oft muss ich meine hände waschen, wenn ich außer haus war, um mich vor dem coronavirus zu schützen	intent:protect_yourself
wie viel abstand zu anderen personen ist sinnvoll, um sich zu schützen	intent:protect_yourself
wie viele minuten sollte ich mir die hände waschen, um das coronavirus zu verhindern	intent:protect_yourself
wird eine gesichtsmaske verhindern, dass ich mich mit corona infiziere	intent:protect_yourself
wo genau muss ich eine gesichtsmaske tragen, um eine ansteckung an corona zu vermeiden	intent:protect_yourself
was sind die schutzmaßnahme gegen coronavirus	intent:protect_yourself
bringt desinfektionsmittel etwas gegen das coronavirus	intent:protect_yourself
gibt es irgendwas was ich kaufen kann um eine ansteckung mit dem coronavirus zu verhindern	intent:protect_yourself
helfen masken gegen eine ansteckung mit dem virus	intent:protect_yourself
helfen masken mit der ffp2 spezifikation gegen den coronavirus	intent:protect_yourself
hilft social distancing die ansteckung mit dem coronavirus zu vermeiden	intent:protect_yourself
können masken bei der ausbreitung von covid19 helfen	intent:protect_yourself
nenn mir sicherheitsmaßnahmen zum schutz vor corona	intent:protect_yourself
reicht normales händewaschen um mich vor dem virus zu schützen	intent:protect_yourself
sollte ich eine schutzmaske anziehen wenn ich das haus verlasse	intent:protect_yourself
was kann ich tun gegen die verbreitung von covid-19 in meiner familie	intent:protect_yourself
was sind die wichtigsten und effektivsten maßnahmen zum persönlichen schutz	intent:protect_yourself
was sind geeignete maßnahmen sich vor einer ansteckung mit dem virus zu schützen	intent:protect_yourself
welche desinfektionsmittel helfen gegen coronavirus	intent:protect_yourself
welche vorbeugungsmaßnahmen kann ich treffen	intent:protect_yourself
welche vorsichtsmaßnahmen kann ich für meine kinder treffen	intent:protect_yourself
welchen mindestabstand soll man einhalten	intent:protect_yourself
wie desinfiziere ich meine schutzmaske richtig	intent:protect_yourself
wie hilfreich ist ein mundschutz um eine ansteckung zu vermeiden	intent:protect_yourself
wie können sich risikopatienten vor corona schützen	intent:protect_yourself
wie kann das risiko einer virusinfektion verringert werden	intent:protect_yourself
wie kann ich mich am besten vor einer ansteckung mit dem coronavirus schützen	intent:protect_yourself
wie kann ich risikogruppen vor einer ansteckung am besten schützen	intent:protect_yourself
wie kann man einer coronavirus infektion vorbeugen	intent:protect_yourself
wie kann man sich beim einkauf vor corona schützen	intent:protect_yourself
wie kann man sich vor einer corona-infektion schützen	intent:protect_yourself
wie lange hält sich corona auf oberflächen	intent:protect_yourself
wie muss ich mich verhalten um mich nicht mit coronavirus anzustecken	intent:protect_yourself
wie oft sollte ich jeden tag meine hände waschen	intent:protect_yourself
wie schütze ich meine kinder vor corona	intent:protect_yourself
wie schütze ich mich am besten in der öffentlichkeit vor einer ansteckung	intent:protect_yourself
wie schütze ich mich vor einer ansteckung mit dem coronavirus	intent:protect_yourself
wie schützt man sich in öffentlichen verkehrsmittel vor dem coronavirus	intent:protect_yourself
wie vermeide ich eine ansteckung mit corona	intent:protect_yourself
wie viel abstand muss ich bei corona einhalten	intent:protect_yourself
wie viel abstand vor anderen passanten um mich zu schützen	intent:protect_yourself
wie viel zeit sollte für die reinigung der hände aufgewendet werden	intent:protect_yourself
wie wirksam ist die nutzung einer gesichtsmaske gegen die infektion mit dem coronavirus	intent:protect_yourself
wo kann man gesichtsmasken zum schutz vor dem virus kaufen	intent:protect_yourself
woher bekomme ich einen günstigen mundschutz	intent:protect_yourself
erkläre mir, was genau das coronavirus ist	intent:what_is_corona
ich möchte wissen, was coronavirus ist	intent:what_is_corona
informationen zum coronavirus bitte	intent:what_is_corona
sag mir bitte, was das coronavirus ist	intent:what_is_corona
sage mir bitte, was das coronavirus ist	intent:what_is_corona
warum geht es beim corona virus	intent:what_is_corona
warum heißt der coronavirus, covid 19	intent:what_is_corona
was passiert, wenn ich das coronavirus habe	intent:what_is_corona
was passiert, wenn man sich mit dem coronavirus angesteckt hat	intent:what_is_corona
wie viele tage dauert es, um infiziert zu werden	intent:what_is_corona
aktuelle situation über coronavirus	intent:what_is_corona
alle infos über das coronavirus	intent:what_is_corona
alle infos über das coronavirus	intent:what_is_corona
alles wissenswerte über das coronavirus bitte	intent:what_is_corona
auskunft über coronavirus bitte	intent:what_is_corona
befällt das virus nur die oberen atemwege oder auch weitere organe	intent:what_is_corona
beschreibe die eigenschaften des coronaviruses	intent:what_is_corona
bitte erläutere mir was sars-cov-2 ist	intent:what_is_corona
bitte informiere mich über den corona virus	intent:what_is_corona
bitte mehr informationen über das coronavirus	intent:what_is_corona
bitte nähere infos zum aktuellen coronavirus	intent:what_is_corona
erkläre für mich das coronavirus	intent:what_is_corona
erkläre mir bitte was genau der corona virus mit meinem körper macht	intent:what_is_corona
erzähle mir die fakten über das coronavirus	intent:what_is_corona
gib mir die aktuellen informationen über den coronavirus	intent:what_is_corona
gib mir die neuesten erkenntnisse über das coronavirus	intent:what_is_corona
gib mir informationen über den corona virus	intent:what_is_corona
ich brauche mehr informationen über das coronavirus	intent:what_is_corona
ist der coronavirus gefährlicher als die influenza	intent:what_is_corona
ist dieser coronavirus wirklich sehr gefährlich	intent:what_is_corona
ist dieses virus ein natürliches virus oder stammt es aus einem versuchslabor	intent:what_is_corona
kann ich informationen zu diesem virus haben	intent:what_is_corona
kannst du etwas mehr von coronavirus erzählen	intent:what_is_corona
kannst du mich etwas über coronavirus informieren	intent:what_is_corona
kannst du mir information über das virus suchen	intent:what_is_corona
kannst du mir mehr über das coronavirus sagen	intent:what_is_corona
kannst du mir mehr informationen über das coronavirus geben	intent:what_is_corona
nenne mir bitte weitere informationen zum coronavirus	intent:what_is_corona
sage mir bitte was das coronavirus überhaupt ist	intent:what_is_corona
seit wann gibt es das coronavirus	intent:what_is_corona
wann wurden die ersten fälle über das corona virus in der öffentlichkeit gemeldet	intent:what_is_corona
warum gibt es gegen corona viren keinen impfstoff	intent:what_is_corona
warum ist corona so gefährlich	intent:what_is_corona
warum ist das coronavirus so gefährlich	intent:what_is_corona
was ist der aktuelle wissensstand bezüglich des coronavirus	intent:what_is_corona
was ist der coronavirus eigentlich	intent:what_is_corona
was ist der unterschied zwischen covid-19 und corona	intent:what_is_corona
was ist der unterschied zwischen dem coronavirus und einer grippe	intent:what_is_corona
was ist der wissensstand bezüglich corona	intent:what_is_corona
was kannst du mir über das coronavirus sagen	intent:what_is_corona
was soll man wissen von corona virus	intent:what_is_corona
was versteht man unter dem begriff coronavirus	intent:what_is_corona
welche symptome hat eine infektion mit corona	intent:what_is_corona
wie überträgt sich das coronavirus	intent:what_is_corona
wie greift coronavirus unsere körper an	intent:what_is_corona
wie hoch ist die ansteckungsrate beim virus	intent:what_is_corona
wie infiziert man sich mit coronavirus	intent:what_is_corona
wie ist coronavirus aufgetreten	intent:what_is_corona
wie ist der krankheitsverlauf beim coronavirus	intent:what_is_corona
wie lange lebt der virus in der luft	intent:what_is_corona
wie lautet der fachbegriffür das coronavirus	intent:what_is_corona
wie schnell breitet sich das coronavirus aus	intent:what_is_corona
wie tödlich ist das coronavirus	intent:what_is_corona
wie unterscheidet sich covid-19 von der normalen grippe	intent:what_is_corona
wie verbreitet sich das coronavirus	intent:what_is_corona
wie viele mutationen vom coronavirus sind bekannt	intent:what_is_corona
wie wird das coronavirus übertragen	intent:what_is_corona
wird das coronavirus imfrühling verschwinden	intent:what_is_corona
woher stammt das coronavirus	intent:what_is_corona
worin unterscheiden sich coronavirus und grippe	intent:what_is_corona
bei welchem symptomen weiß ich, dass ich corona habe	intent:what_are_symptoms
welche symptome hat man, wenn man an corona erkrankt ist	intent:what_are_symptoms
wie bemerke ich, dass ich das coronavirus habe	intent:what_are_symptoms
wie kann man erkennen, dass jemand an corona erkrankt ist	intent:what_are_symptoms
wie merke ich, dass ich möglicherweise mit dem coronavirus infiziert bin	intent:what_are_symptoms
wie sehen die symptome aus, wenn man corona hat	intent:what_are_symptoms
wie weiß ich, ob ich das coronavirus habe	intent:what_are_symptoms
woher weiß ich, ob ich mit covid angesteckt bin	intent:what_are_symptoms
woher weiss ich, dass ich mich mit corona infiziert habe	intent:what_are_symptoms
woran merke ich, ob ich mit corona infiziert bin	intent:what_are_symptoms
auf welche möglichen symptome bei corona muss ich achten	intent:what_are_symptoms
bei welchen symptomen habe ich mich mit corona infiziert	intent:what_are_symptoms
ist fieber auch ein symptom von corona	intent:what_are_symptoms
ist verschleimter husten ein zeichen für corona	intent:what_are_symptoms
kann man eine lungenentzündung bei corona bekommen	intent:what_are_symptoms
kann man mit schnupfen corona haben	intent:what_are_symptoms
kannst du mir die häufigsten symptome des virus nennen	intent:what_are_symptoms
muss ich bei corona husten	intent:what_are_symptoms
nenne die symptome des coronaviruses	intent:what_are_symptoms
nenne mir die anzeichen einer coronaviruserkrankung	intent:what_are_symptoms
nenne mir die leitsymptome bei corona	intent:what_are_symptoms
sind bauchschmerzen ein symptomfür corona virus	intent:what_are_symptoms
sind corona symptome schmerzhaft	intent:what_are_symptoms
sind fieber und kopfschmerzen symptome von corona	intent:what_are_symptoms
sind halsschmerzen ein coronasymptom	intent:what_are_symptoms
sind kopfschmerzen ein anzeichenfür corona	intent:what_are_symptoms
symptome von corona	intent:what_are_symptoms
unterschiede anzeichen grippe und coronavirus	intent:what_are_symptoms
wann habe ich corona	intent:what_are_symptoms
wann sollte ich mich auf das coronavirus testen lassen	intent:what_are_symptoms
wann treten bei corona die ersten symptome auf	intent:what_are_symptoms
was deutet auf corona hin	intent:what_are_symptoms
was deutet auf eine coronainfektion hin	intent:what_are_symptoms
was deutet auf eine erkrankung mit corona hin	intent:what_are_symptoms
was die symptome vom coronavirus	intent:what_are_symptoms
was für symptome gibt es bei einer coronaviruserkrankung	intent:what_are_symptoms
was für symptome treten bei coronavirus auf	intent:what_are_symptoms
was ist bisher über die symptome von covid-19 bekannt	intent:what_are_symptoms
was ist das häufigste anzeichen	intent:what_are_symptoms
was sind die anzeichen vom coronavirus	intent:what_are_symptoms
was sind die ersten anzeichen einer coronainfektion	intent:what_are_symptoms
was sind die ersten symptome des coronavirus	intent:what_are_symptoms
was sind die genauen symptome von corona	intent:what_are_symptoms
was sind die häufigste symptome vom coronavirus	intent:what_are_symptoms
was sind die symptome des neuen coronavirus	intent:what_are_symptoms
was sind die symptome einer corona-infektion	intent:what_are_symptoms
was sind die symptomef ür corona	intent:what_are_symptoms
was sind die symptome vom coronavirus	intent:what_are_symptoms
was sind die typische symptomen für coronavirus	intent:what_are_symptoms
was sind die typischen symptome vom coronavirus	intent:what_are_symptoms
was sind die wichtigsten symptome vom coronavirus	intent:what_are_symptoms
was sind hinweise für eine ansteckung mir dem coronavirus	intent:what_are_symptoms
was sind typische symptome bei corona	intent:what_are_symptoms
was sprichtfür eine corona infektion	intent:what_are_symptoms
welche allgemeinen symptome gibt es	intent:what_are_symptoms
welche anzeichen deuten auf corona hin	intent:what_are_symptoms
welche anzeichen gibt es für corona	intent:what_are_symptoms
welche coronavirus symptome gibt es	intent:what_are_symptoms
welche krankheitszeichen deuten auf eine infektion mit corona hin	intent:what_are_symptoms
welche symptome hat man bei einer coronavirus erkrankung	intent:what_are_symptoms
welche symptome sind typisch für das coronavirus	intent:what_are_symptoms
welche symptome treten bei einer infektion mit covid19 auf	intent:what_are_symptoms
welche symptome weise ich auf wenn ich corona habe	intent:what_are_symptoms
welches sind die leitsymptome bei corona	intent:what_are_symptoms
welches sind die symptome von covid-19	intent:what_are_symptoms
wie diagnostiziert man eine coronaerkrankung	intent:what_are_symptoms
wie genau äußert sich der coronavirus	intent:what_are_symptoms
wie kann das coronavirus festgestellt werden	intent:what_are_symptoms
wie sind die symptome von corona	intent:what_are_symptoms
woher weiß ich ob ich mit dem coronavirus infiziert bin	intent:what_are_symptoms
woran erkenne ich eine erkrankung an covid-19	intent:what_are_symptoms
woran kann ich erkennen ob ich mich mit corona infiziert habe	intent:what_are_symptoms
informationen über den übertragungsweg von corona	intent:how_does_corona_spread
krieg ich corona, wenn mich jemand anfasst	intent:how_does_corona_spread
reicht social distancing aus, um sich nicht mit dem virus anzustecken	intent:how_does_corona_spread
wie überträgt sich der corona virus im supermarkt	intent:how_does_corona_spread
wird das virus durch händeschütteln übertragen	intent:how_does_corona_spread
auf welchem wege verbreitet sich dieses neue coronavirus	intent:how_does_corona_spread
auf welchen oberflächen ist das virus besonders lange aktiv	intent:how_does_corona_spread
auf welchen wege kann der coronavirus übertragen werden	intent:how_does_corona_spread
haftet das corona virus lange an papier	intent:how_does_corona_spread
haftet das virus auf paketen	intent:how_does_corona_spread
ist das coronavirus an türklinken überlebensfähig	intent:how_does_corona_spread
ist das virus durch speichel übertragbar	intent:how_does_corona_spread
ist das virus in der luft übertragbar	intent:how_does_corona_spread
ist der virus von mensch zu mensch übertragbar	intent:how_does_corona_spread
können bettwanzen den coronavirus auf anderen menschen verbreiten	intent:how_does_corona_spread
können die tiere das coronavirus übertragen	intent:how_does_corona_spread
können tiere mich mit covid- 19 anstecken	intent:how_does_corona_spread
kann coronaüber lebensmittel übertragen werden	intent:how_does_corona_spread
kann das virus über gegenstände und lebensmittel übertragen werden	intent:how_does_corona_spread
kann das virus über husten weitergegeben werden	intent:how_does_corona_spread
kann das virus durch die haut übertragen werden	intent:how_does_corona_spread
kann das virus durch die luft verbreiten werden	intent:how_does_corona_spread
kann das virus durch handelswaren übertragen werden	intent:how_does_corona_spread
kann das virus durch körperkontakt verbreitet werden	intent:how_does_corona_spread
kann das virus im essen enthalten sein	intent:how_does_corona_spread
kann der coronavirus auf produkten im supermarkt übertragen werden	intent:how_does_corona_spread
kann der virus auf oberflächen überleben	intent:how_does_corona_spread
kann die krankheit über das grundwasser übertragen werden	intent:how_does_corona_spread
kann eine schwangere den virus auf ihr kind übertragen	intent:how_does_corona_spread
kann ich beim busfahren korona bekommen	intent:how_does_corona_spread
kann ich das corona virus von meinen haustieren bekommen oder an sie übertragen	intent:how_does_corona_spread
kann ich mich anstecken wenn ich einen coronakranken umarme	intent:how_does_corona_spread
kann ich mich bei erkrankten personen in der bahn anstecken	intent:how_does_corona_spread
kann ich mich im supermarkt mit corona infizieren	intent:how_does_corona_spread
kann sich das virus durch tiere verbreiten	intent:how_does_corona_spread
kommt das coronavirus von fledermäusen	intent:how_does_corona_spread
verbreitet sich das virus nur über tröpfcheninfektion	intent:how_does_corona_spread
von welchen oberflächen kann ich das coronavirus bekommen	intent:how_does_corona_spread
was muss man beachten das man dass coronavirus nicht verbreiten sollte	intent:how_does_corona_spread
was sind die übertragungswege vom virus	intent:how_does_corona_spread
welche übertragungswege gibt es beim coronavirus	intent:how_does_corona_spread
welche tiere haben corona übertragen	intent:how_does_corona_spread
welche tiere können das virus übertragen	intent:how_does_corona_spread
welche verbreitungsmöglichkeiten gibt es	intent:how_does_corona_spread
welcher ist der wichtigste übertragungsweg für covid neunzehn	intent:how_does_corona_spread
welches sind die häufigsten ursachen der verbreitung des virus	intent:how_does_corona_spread
wie überträgt sich das neuartige coronavirus	intent:how_does_corona_spread
wie kann corona übertragen werden	intent:how_does_corona_spread
wie kann das coronavirus übertragen	intent:how_does_corona_spread
wie kann das virus übertragen werden	intent:how_does_corona_spread
wie läuft die verbreitung des coronavirus	intent:how_does_corona_spread
wie lange hält sich covid- 19 auf türklinken oder einkaufswagen	intent:how_does_corona_spread
wie lange kann das coronavirus auf oberflächen überleben	intent:how_does_corona_spread
wie lange kann der virus auf postpaketen überleben	intent:how_does_corona_spread
wie sind die infektionswege dieser krankheit	intent:how_does_corona_spread
wie steckt man sich mit coronavirus an	intent:how_does_corona_spread
wie waren die verbreitungswege des coronaviruses	intent:how_does_corona_spread
wie wird das coronavirus übertragen	intent:how_does_corona_spread
wie wird das neuartige coronavirus übertragen	intent:how_does_corona_spread
wie wird der coronavirus übertragen	intent:how_does_corona_spread
wir das coronavirus über türklinken übertragen	intent:how_does_corona_spread
wird covid19 über das händeschütteln übertragen	intent:how_does_corona_spread
wird das coronavirus über die luft übertragen	intent:how_does_corona_spread
wird das coronavirus über die luft verbreitet	intent:how_does_corona_spread
wird das coronavirus durch bargeld übertragen	intent:how_does_corona_spread
wird das virus über hunde übertragen	intent:how_does_corona_spread
wird der virus über tröpfeninfektion übertragen	intent:how_does_corona_spread
wird der virus per handschlag übertragen	intent:how_does_corona_spread
ich würde gerne wissen, ob haustier mit dem virus infiziert werden kann	intent:can_i_get_from_feces_animal_pets
ist es möglich, dass sich katzen mit dem coronavirus anstecken	intent:can_i_get_from_feces_animal_pets
kann ich corona kriegen, wenn ich einen fremden hund streichle	intent:can_i_get_from_feces_animal_pets
überträgt mein hund coronavirus	intent:can_i_get_from_feces_animal_pets
überträgt sich das coronavirus auf hunde	intent:can_i_get_from_feces_animal_pets
überträgt sich corona zwischen mensch und tier	intent:can_i_get_from_feces_animal_pets
überträgt sich das coronavirus von haustiere zu menschen	intent:can_i_get_from_feces_animal_pets
gibt es im pferdestall ein erhöhtes risiko durch übertragung von pferden	intent:can_i_get_from_feces_animal_pets
ist es gefährlich für meine katze	intent:can_i_get_from_feces_animal_pets
ist es möglich durch fleisch infiziert zu werden	intent:can_i_get_from_feces_animal_pets
ist es möglich sich von einem hundebiss mit corona zu infizieren	intent:can_i_get_from_feces_animal_pets
können die tiere auch infiziert werden	intent:can_i_get_from_feces_animal_pets
können die tiere mich an corona anstecken	intent:can_i_get_from_feces_animal_pets
können flöhe den virus verbreiten	intent:can_i_get_from_feces_animal_pets
können haustiere covid-19 übertragen	intent:can_i_get_from_feces_animal_pets
können meine haustiere das coronavirus übertragen	intent:can_i_get_from_feces_animal_pets
können meine katzen mich mit dem coronavirus anstecken	intent:can_i_get_from_feces_animal_pets
können tiere an corona erkranken und mich infizieren	intent:can_i_get_from_feces_animal_pets
können tiere coronavirus übertragen	intent:can_i_get_from_feces_animal_pets
können tiere sich vom menschen mit corona anstecken	intent:can_i_get_from_feces_animal_pets
können vögel den coronavirus verbreiten	intent:can_i_get_from_feces_animal_pets
kam das coronavirus durch tiere auf den menschen	intent:can_i_get_from_feces_animal_pets
kam der corona virus von fledermäusen	intent:can_i_get_from_feces_animal_pets
kann corona von meiner katze auf mich überspringen	intent:can_i_get_from_feces_animal_pets
kann das coronavirus über den kot meines haustieres übertragen werden	intent:can_i_get_from_feces_animal_pets
kann das coronavirus durch die tiere übertagen werden	intent:can_i_get_from_feces_animal_pets
kann ich corona von einem tier bekommen	intent:can_i_get_from_feces_animal_pets
kann ich corona von meiner katze bekommen	intent:can_i_get_from_feces_animal_pets
kann ich das coronavirus aus gemüse bekommen	intent:can_i_get_from_feces_animal_pets
kann ich das virus von meiner katze bekommen	intent:can_i_get_from_feces_animal_pets
kann ich durch fleischverzehr corona bekommen	intent:can_i_get_from_feces_animal_pets
kann ich gefahrlos fleisch essen	intent:can_i_get_from_feces_animal_pets
kann ich mein haustier mit corona anstecken	intent:can_i_get_from_feces_animal_pets
kann ich meine haustiere bedenken los füttern oder muss ich auf etwas bezüglich des virus beachten	intent:can_i_get_from_feces_animal_pets
kann ich meine haustiere mit dem virus anstecken	intent:can_i_get_from_feces_animal_pets
kann ich meinen hund mit dem coronavirus anstecken	intent:can_i_get_from_feces_animal_pets
kann ich meinen kater anstecken	intent:can_i_get_from_feces_animal_pets
kann ich mich über meinen hund mit corona infizieren	intent:can_i_get_from_feces_animal_pets
kann ich mich über tiere mit dem virus anstecken	intent:can_i_get_from_feces_animal_pets
kann ich mich bei meinem hund anstecken	intent:can_i_get_from_feces_animal_pets
kann ich mich durch das streicheln von fremden haustieren infizieren	intent:can_i_get_from_feces_animal_pets
kann ich mich durch den verzehr einer fledermaus suppe infizieren	intent:can_i_get_from_feces_animal_pets
kann ich mich durch den verzehr von fleisch mit dem coronavirus infizieren	intent:can_i_get_from_feces_animal_pets
kann ich mich durch meine haustiere anstecken	intent:can_i_get_from_feces_animal_pets
kann ich mich durch meinen hund infizieren	intent:can_i_get_from_feces_animal_pets
kann ich mich durch tiere anstecken	intent:can_i_get_from_feces_animal_pets
kann ich mich durch tiere auch vom virus anstecken lassen	intent:can_i_get_from_feces_animal_pets
kann ich mich im zoo bei tieren anstecken	intent:can_i_get_from_feces_animal_pets
kann ich mich mit dem coronavirus infizieren wenn ich infiziertes fleisch esse	intent:can_i_get_from_feces_animal_pets
kann ich mit dem coronavirus infiziertes fleisch essen	intent:can_i_get_from_feces_animal_pets
kann ich noch beruhigt fleisch essen oder muss ich angst haben mich anzustecken	intent:can_i_get_from_feces_animal_pets
kann man das virus von ihrem haustier bekommen	intent:can_i_get_from_feces_animal_pets
kann man den virus and haustiere weitergeben	intent:can_i_get_from_feces_animal_pets
kann man durch die tiere mit corona infiziert werden	intent:can_i_get_from_feces_animal_pets
kann man sich durch mücckenstiche infizieren	intent:can_i_get_from_feces_animal_pets
kann man sich mit dem coronavirus von haustieren anstecken	intent:can_i_get_from_feces_animal_pets
kann mein haustier auch corona bekommen	intent:can_i_get_from_feces_animal_pets
kann mein haustier den virus verbreiten	intent:can_i_get_from_feces_animal_pets
kann mein hund mich mit dem coronavirus anstecken	intent:can_i_get_from_feces_animal_pets
übertragen mücken oder andere stechtiere das coronavirus	intent:can_i_get_from_feces_animal_pets
wird das virus vom tier auf den menschen übertragen	intent:can_i_get_from_feces_animal_pets
wurde das coronavirus von wildtieren übertragen	intent:can_i_get_from_feces_animal_pets
wie bemerke ich das coronavirus bei haustieren	intent:can_i_get_from_feces_animal_pets
kann ich corona bekommen, wenn ich ein paket annehme	intent:can_i_get_from_packages_surfaces
kann ich mich durch gegenstände aus dem supermarkt, auf die jemand gehustet hat, infizieren	intent:can_i_get_from_packages_surfaces
kann ich mich mit covid anstecken, wenn ich eine verseuchte türklinke anfasse	intent:can_i_get_from_packages_surfaces
kannst du mir sagen, ob ich mich durch geliefertes essen anstecken kann	intent:can_i_get_from_packages_surfaces
wie kann ich mich am besten schützen, wenn fremde gegenstände in meine wohnung gelangen	intent:can_i_get_from_packages_surfaces
wie lange lebt das virus auf metallflächen	intent:can_i_get_from_packages_surfaces
überlebt das coronavirus auf meiner kleidung	intent:can_i_get_from_packages_surfaces
überlebt das virus auf dem lenkrad meines autos	intent:can_i_get_from_packages_surfaces
auf welchen oberflächen kann sich das virus festsetzen	intent:can_i_get_from_packages_surfaces
befindet sich das coronavirus auf türklinken	intent:can_i_get_from_packages_surfaces
bleibt das coronavirus an bargeld haften	intent:can_i_get_from_packages_surfaces
braucht das virus eine bestimmte oberflächenstruktur um länger aktiv zu sein	intent:can_i_get_from_packages_surfaces
das virus kann über lebensmittelpakete übertragen werden	intent:can_i_get_from_packages_surfaces
informieren sie mich über verbreitung des coronavirus über oberflächen	intent:can_i_get_from_packages_surfaces
ist der virus auf kalten flächen überlebensfähig	intent:can_i_get_from_packages_surfaces
ist eine infektion mit dem coronavirus über eine papierzeitung oder -zeitschrift möglich	intent:can_i_get_from_packages_surfaces
kann corona virus über handschuhe übertragen werden	intent:can_i_get_from_packages_surfaces
kann covid 19 auf der oberfläche meines telefons leben	intent:can_i_get_from_packages_surfaces
kann das coronavirus über oberflächen übertragen werden	intent:can_i_get_from_packages_surfaces
kann das coronavirus auch durch die annahme von postpaketen übertragen werden	intent:can_i_get_from_packages_surfaces
kann das coronavirus auf verpackungen überleben	intent:can_i_get_from_packages_surfaces
kann das coronavirus durch briefe oder pakete übertragen werden	intent:can_i_get_from_packages_surfaces
kann das virus über den postweg übertragen werden	intent:can_i_get_from_packages_surfaces
kann das virus über flächen im supermarkt übertragen werden	intent:can_i_get_from_packages_surfaces
kann das virus auch über gläser verteilt werden	intent:can_i_get_from_packages_surfaces
kann das virus durch das anfassen der türklinke übertragen werden	intent:can_i_get_from_packages_surfaces
kann das virus länger auf oberflächen überleben	intent:can_i_get_from_packages_surfaces
kann das virus von metall-oberflächen einfach weggewischt werden	intent:can_i_get_from_packages_surfaces
kann das virus von oberflächen auf mich übergehen	intent:can_i_get_from_packages_surfaces
kann der coronavirus über die klobrille übertragen werden	intent:can_i_get_from_packages_surfaces
kann die verbreitung des coronavirus über oberflächen unterbunden werden	intent:can_i_get_from_packages_surfaces
kann ich durch kontakt mit klamotten von einer infizierten person infizieren	intent:can_i_get_from_packages_surfaces
kann ich mich an einer parkbank infizieren	intent:can_i_get_from_packages_surfaces
kann ich mich an wechselgeld mit covid neunzehn anstecken	intent:can_i_get_from_packages_surfaces
kann ich mich anstecken wenn ich ein paket annehme	intent:can_i_get_from_packages_surfaces
kann ich mich auf öffentlichen toiletten mit dem virus anstecken	intent:can_i_get_from_packages_surfaces
kann ich mich beim einkaufen durch das anfassen von lebensmitteln anstecken	intent:can_i_get_from_packages_surfaces
kann ich mich durch pakete mit dem virus infizieren	intent:can_i_get_from_packages_surfaces
kann ich mich durch togo bechner mit corona infizieren	intent:can_i_get_from_packages_surfaces
kann ich mich durch ungewaschenes obst anstecken	intent:can_i_get_from_packages_surfaces
kann ich mich mit corona im fürstuhl anstecken	intent:can_i_get_from_packages_surfaces
kann ich mich mit covid-19 infizieren wenn ich es auf einer plastikflasche anfasse	intent:can_i_get_from_packages_surfaces
kann man sich über lieferungen mir dem coronavirus anstecken	intent:can_i_get_from_packages_surfaces
kann man sich durch obst aus dem supermarkt anstecken	intent:can_i_get_from_packages_surfaces
sind pakete aus china gefährlich für die übertragung des virus	intent:can_i_get_from_packages_surfaces
sterben coronaviren auf metaloberflächen schneller ab	intent:can_i_get_from_packages_surfaces
stirbt das virus auf oberflächenvon alleine ab nach einiger zeit	intent:can_i_get_from_packages_surfaces
unverpacktes gemüse eine infektionsgefahr	intent:can_i_get_from_packages_surfaces
wann stirbt das coronavirus auf metall	intent:can_i_get_from_packages_surfaces
welche lebensdauer hat das virus auf oberflächen	intent:can_i_get_from_packages_surfaces
wie hoch ist das risiko der infizierung durch geld	intent:can_i_get_from_packages_surfaces
wie kann ich mich durch den kontakt auf oberflächen vor dem virus schützen	intent:can_i_get_from_packages_surfaces
wie kann ich mich vor dem virus an gegenständen schützen	intent:can_i_get_from_packages_surfaces
wie lang überlebt das virus auf einer türklinke	intent:can_i_get_from_packages_surfaces
wie lange überlebt das virus auf verpackungen	intent:can_i_get_from_packages_surfaces
wie lange überlebt das virus auf verschiedenen oberflächen	intent:can_i_get_from_packages_surfaces
wie lange bleibt covid-19 auf glatten oberflächen	intent:can_i_get_from_packages_surfaces
wie lange dauert es bis glatte oberflächen nicht mehr infektiös sind	intent:can_i_get_from_packages_surfaces
wie lange hält sich das coronavirus auf dem lenkrad im auto	intent:can_i_get_from_packages_surfaces
wie lange hält sich das virus auf der kleidung	intent:can_i_get_from_packages_surfaces
wie lange hält sich das virus auf holz	intent:can_i_get_from_packages_surfaces
wie lange hält sich das virus auf metal	intent:can_i_get_from_packages_surfaces
wie lange kann das coronavirus auf aufzugsknöpfen leben	intent:can_i_get_from_packages_surfaces
wie lange kann das coronavirus auf einer oberfläche überleben	intent:can_i_get_from_packages_surfaces
wie lange kann das coronavirus auf obst überleben	intent:can_i_get_from_packages_surfaces
wie lange kann das virus auf einem einkaufswagen überleben	intent:can_i_get_from_packages_surfaces
wie lange kann das virus auf oberflächen überleben	intent:can_i_get_from_packages_surfaces
wie lange kann dass virus auf einer oberfläche überleben	intent:can_i_get_from_packages_surfaces
wie lange kann dass virus auf plastik überleben	intent:can_i_get_from_packages_surfaces
ich komme gerade aus shanghai, ist das ein hochrisikogebiet	intent:what_if_i_visited_high_risk_area
ich komme gerade aus spanien, was nun	intent:what_if_i_visited_high_risk_area
ich muss nächste woche nach china, welche vorkehrungen muss ich treffen	intent:what_if_i_visited_high_risk_area
ich war gerade in der lombardei, was sollte ich tun	intent:what_if_i_visited_high_risk_area
ich war im skiurlaub in ischgl, muss ich mir sorgen machen	intent:what_if_i_visited_high_risk_area
ich war in einem hochrisikogebiet, was soll ich denn jetzt tun	intent:what_if_i_visited_high_risk_area
ich war in ischgl, soll ich mich testen lassen	intent:what_if_i_visited_high_risk_area
ich war in wuhan, muss ich mich testen lassen	intent:what_if_i_visited_high_risk_area
ich war vor kurzem in südkorea, was soll ich tun	intent:what_if_i_visited_high_risk_area
ist es gefährlich mit leuten kontakt zu haben, die gerade aus hochrisikogebieten kommen	intent:what_if_i_visited_high_risk_area
jemand kam gerade aus italien zurück geflogen, ist das gefährlich	intent:what_if_i_visited_high_risk_area
kann ich personen treffen, die in italien waren,über keine symptome zeigen	intent:what_if_i_visited_high_risk_area
kannst du mir alle hochrisikogebiete von corona nennen, damit ich weiß ob ich mir sorgen machen muss	intent:what_if_i_visited_high_risk_area
muss ich jemandem melden, dass ich vor zwei monaten in china war	intent:what_if_i_visited_high_risk_area
soll ich maske tragen, wenn ich in einer hochrisikoländer gewesen bin	intent:what_if_i_visited_high_risk_area
soll mein vater, der im italienischen skigebiet urlaub gemacht hat, sich in quarantäne begeben	intent:what_if_i_visited_high_risk_area
sollen menschen, die aus hochrisikogebieten zurückkehren, in quarantäne	intent:what_if_i_visited_high_risk_area
sollte ich den arzt besuchen, wenn ich vor einem monat in italien gewesen bin	intent:what_if_i_visited_high_risk_area
was ist das protokoll für personen, die kürzlich gebiete mit hohem risiko für coronavirus besucht haben	intent:what_if_i_visited_high_risk_area
was muss ich beachten, wenn ich aus einem hochrisikogebiet komme	intent:what_if_i_visited_high_risk_area
was muss ich tun, wenn ich aus einem risikogebiet zurückkehre	intent:what_if_i_visited_high_risk_area
was muss ich tun, wenn ich ein hochrisikogebiet besucht habe	intent:what_if_i_visited_high_risk_area
was muss ich tun, wenn ich kürzlich an orte mit hohem risiko gereist bin	intent:what_if_i_visited_high_risk_area
was sind die maßnahmen, wenn ich aus einem risikoland komme	intent:what_if_i_visited_high_risk_area
was soll ich machen, wenn ich gerade in ein hochrisikogebiet gewesen bin	intent:what_if_i_visited_high_risk_area
was soll ich tun , wenn ich einen kontakt mit einer aus einem hochrisikogebiet hatte	intent:what_if_i_visited_high_risk_area
was soll ich tun, nachdem ich ein gebiet mit hohem risiko besucht habe	intent:what_if_i_visited_high_risk_area
was soll ich tun, wenn ich in einem hochrisikogebiet von coronavirus bin	intent:what_if_i_visited_high_risk_area
was soll ich tun, wenn ich kürzlich in einem hochrisikogebiet war	intent:what_if_i_visited_high_risk_area
was sollen die menschen tun, wenn sie an einem corona-hotspot gewesen sind	intent:what_if_i_visited_high_risk_area
was, wenn ich aus einem risikogebiet komme	intent:what_if_i_visited_high_risk_area
welche maßnahmen muss ich ergreifen, falls ich vor kurzem in einem hochrisikogebiet war	intent:what_if_i_visited_high_risk_area
welche maßnahmen soll ich ergreifen, wenn ich gerade aus italien zurückgekommen bin	intent:what_if_i_visited_high_risk_area
wie ist die vorgehensweise, bei besuchen in großstädten	intent:what_if_i_visited_high_risk_area
wie lange sollte ich in quarantäne bleiben, nachdem ich in einem ochrisikogebiet war	intent:what_if_i_visited_high_risk_area
wie lange wird man unter quarantäne gestellt, wenn man in einem hochrisikoland war	intent:what_if_i_visited_high_risk_area
wie muss ich mich verhalten, wenn ich kürzlich ein hochrisikoland besucht habe	intent:what_if_i_visited_high_risk_area
wie soll ich mich verhalten, wenn ich aus einem risikogebiet komme	intent:what_if_i_visited_high_risk_area
wie soll man sich verhalten, wenn man vor kurzem in wuhan war	intent:what_if_i_visited_high_risk_area
wie sollte ich vorgehen, wenn ich gerade in china war	intent:what_if_i_visited_high_risk_area
wie verhalte ich mich, nachdem ich aus einem hochrisikogebiet wiederkomme	intent:what_if_i_visited_high_risk_area
anleitung für die schritte nach der einreise aus einem hochrisikogebiet	intent:what_if_i_visited_high_risk_area
ich möchte informationen über die hochrisikogebiete in der welt haben	intent:what_if_i_visited_high_risk_area
ich war kürzlich in china. was soll ich tun	intent:what_if_i_visited_high_risk_area
ich war vor sieben wochen im elsass. sollte ich mich testen lassen	intent:what_if_i_visited_high_risk_area
ist es sicher mit menschen die aus hochrisikogebieten kommen zu leben	intent:what_if_i_visited_high_risk_area
kann ich trotz des coronavirus zurzeit nach china reisen	intent:what_if_i_visited_high_risk_area
kann ich trotzdem nach madrid zu meiner familie fahren	intent:what_if_i_visited_high_risk_area
maßnahmen nach besuch eines hochrisikigebietes corona	intent:what_if_i_visited_high_risk_area
mein nachbar war in china kann ich ihn noch grüßen	intent:what_if_i_visited_high_risk_area
muss ich in quarantäne weil ich italien war	intent:what_if_i_visited_high_risk_area
muss ich mich beim gesundheitsamt melden und mich testen lassen wenn ich in einem risiko land war	intent:what_if_i_visited_high_risk_area
muss ich mich nach dem aufenthalt in einem hochrisikogebiet irgendwo melden	intent:what_if_i_visited_high_risk_area
muss man sich nach einreise aus einem hochrisikoland in quarantäne begeben	intent:what_if_i_visited_high_risk_area
sollte ich aus einem risiko land direkt ausreisen	intent:what_if_i_visited_high_risk_area
sollte ich in selbstisolation gehen wenn ich in china war	intent:what_if_i_visited_high_risk_area
was ist nach rückkehr aus einem risikogebiet zu tun	intent:what_if_i_visited_high_risk_area
was muss ich beachten wenn ich in einem hot spot gebiet gewesen bin	intent:what_if_i_visited_high_risk_area
was tun wenn ich kontakt zu leuten aus krisengebiet hatte	intent:what_if_i_visited_high_risk_area
was tun wenn man in einem hochrisikogebiet war	intent:what_if_i_visited_high_risk_area
welche maßnahmen muss man machen wenn man aus hochrisikogebiet kommt	intent:what_if_i_visited_high_risk_area
wie lange muss ich in die quarantäne bleiben wenn ich in risikogebieten war	intent:what_if_i_visited_high_risk_area
wie soll ich mich nach der rückkehr aus einem risikogebiet verhalten	intent:what_if_i_visited_high_risk_area
wie verhalte ich mich wenn ich aus einem hochrisikogebiet komme	intent:what_if_i_visited_high_risk_area
wo melde ich mich wenn ich in einem hochrisikogebiet war	intent:what_if_i_visited_high_risk_area
worauf soll ich achten wenn ich im betroffenen ischgl skiurlaub gemacht habe	intent:what_if_i_visited_high_risk_area
gibt es eine möglichkeit, corona zu heilen	intent:what_are_treatment_options
gibt es medikamente, die corona heilen	intent:what_are_treatment_options
kannst du mir sagen, wie man covid behandelt	intent:what_are_treatment_options
muss man ins krankenhaus, wenn man sich infiziert hat	intent:what_are_treatment_options
sag mir, wie man von coronavirus heilen kann	intent:what_are_treatment_options
sage mir, wie ich eine infektion mit covid neunzehn am besten auskuriere	intent:what_are_treatment_options
was kann ich tun, um coronasymptome zu lindern	intent:what_are_treatment_options
welche fortschritte macht die forschung, um corona zu heilen	intent:what_are_treatment_options
welche medikamente muss ich nehmen, wenn ich das coronavirus habe	intent:what_are_treatment_options
wie ist es möglich, das virus zu heilen	intent:what_are_treatment_options
wie kann man corona heilen	intent:what_are_treatment_options
wie lange dauert es, bis die krankheit geheilt ist	intent:what_are_treatment_options
wie lautet die heilungsmethode, wenn man an corona erkrankt ist	intent:what_are_treatment_options
aktuelle heilungsansätze corona	intent:what_are_treatment_options
behandelt mein hausarzt auch corona	intent:what_are_treatment_options
behandlung bei coronainfektion	intent:what_are_treatment_options
behandlungsmöglichkeiten von corona anzeigen	intent:what_are_treatment_options
behandlungsmethoden bei coronavirus	intent:what_are_treatment_options
coronavirus behandlung zu hause	intent:what_are_treatment_options
gibt es bald eine impfung gegen corona	intent:what_are_treatment_options
gibt es medikamente gegen corona	intent:what_are_treatment_options
gibt es effiziente heilungsmethoden für corona infizierte	intent:what_are_treatment_options
gibt es ein corona gegenmittel	intent:what_are_treatment_options
gibt es ein gegenmittle für coronavirus	intent:what_are_treatment_options
gibt es ein gutes medikament gegen corona	intent:what_are_treatment_options
gibt es ein heilmittel gegen corona	intent:what_are_treatment_options
gibt es ein medikament gegen das virus	intent:what_are_treatment_options
gibt es ein medikamet gegen corona	intent:what_are_treatment_options
gibt es eine heilmethode für coronavirus	intent:what_are_treatment_options
gibt es eine impfung gegen das coronavirus	intent:what_are_treatment_options
gibt es eine schutzimpfung für sars-cov-2	intent:what_are_treatment_options
gibt es einen zugelassenen medikament für das coronavirus	intent:what_are_treatment_options
gibt es homöopathische mittel gegen corona	intent:what_are_treatment_options
gibt es inzwischen einen impfstoff für corona	intent:what_are_treatment_options
gibt es schon ein heilmittel gegen coronavirus	intent:what_are_treatment_options
gibt es schon einen impfstoff gegen das coronavirus	intent:what_are_treatment_options
heilungsmöglichkeiten durch homöopathie	intent:what_are_treatment_options
helfen malaria-mittel gegen das coronavirus	intent:what_are_treatment_options
hilft homeopathie gegen den coronavirus	intent:what_are_treatment_options
kann corona mit remdesivir behandelt werden	intent:what_are_treatment_options
kann ebola-medikament helfen	intent:what_are_treatment_options
kann man sich gegen den virus impfen lassen	intent:what_are_treatment_options
kann man vollständig von corona geheilt werden	intent:what_are_treatment_options
was für medikamente gibt es um corona zu heilen	intent:what_are_treatment_options
was hilft wenn man sich infiziert hat	intent:what_are_treatment_options
welche behandlungen werden gegen die corona krankheit angewendet	intent:what_are_treatment_options
welche behandlungsmöglichkeit gibt es zum virus	intent:what_are_treatment_options
welche behandlungsmöglichkeiten stehen für das neuartige coronavirus zur verfügung	intent:what_are_treatment_options
welche behandlungsmethoden gibt es für corona	intent:what_are_treatment_options
welche möglichkeiten zur behandlung eines infizierten gibt es aktuell	intent:what_are_treatment_options
welche medikamente können coronavirussymptome lindern	intent:what_are_treatment_options
welche medikamente können gegen das virus wirken	intent:what_are_treatment_options
welche therapien gibt es gegen corona	intent:what_are_treatment_options
wie behandelt man eine infektion mit dem coronavirus	intent:what_are_treatment_options
wie hoch ist die heilungschance bei einem schweren verlauf	intent:what_are_treatment_options
wie lässt sich das coronavirus behandeln	intent:what_are_treatment_options
wie schlimm ist die coronavirus krankheit	intent:what_are_treatment_options
wie schnell wird es eine heilung des coronavirus geben	intent:what_are_treatment_options
wie sehen die behandlungsmöglichkeiten für den coronavirus aus	intent:what_are_treatment_options
wie werden das virus und die symptome behandelt	intent:what_are_treatment_options
wie werden patienten mit einer coronainfektion behandelt	intent:what_are_treatment_options
wie wird eine erkrankung an covid-19 behandelt	intent:what_are_treatment_options
wird es dieses jahr einen impfstoff gegen covid-19 geben	intent:what_are_treatment_options
wurde schon ein impfstoff gegen das virus entwickelt	intent:what_are_treatment_options
zeige mir effektive heilmethoden	intent:what_are_treatment_options
ist an dem mythos, dass bill gates hinter covid-19 steckt, etwas dran	intent:myths
ist das ein fakenews, dass corona-infizierte sich selbst testen können	intent:myths
ist ein mythos, dass kinder nicht am coronavirus erkranken können	intent:myths
ist es echt oder nur ein märchen, dass der virus im labor gezüchtet wurde	intent:myths
ist es ein märchen, dass tiere menschen anstecken können	intent:myths
ist es ein mythos dass covid 19 jüngere menschen eher gefährdet	intent:myths
ist es ein mythos, dass die grippe genauso gefährlich ist wie das coronavirus	intent:myths
ist es ein mythos, dass chinesen ihre haustiere getötet haben	intent:myths
ist es ein mythos, dass corona über 5g übertragen wird	intent:myths
ist es ein mythos, dass corona durch die luft übertragen werden kann	intent:myths
ist es ein mythos, dass corona mit einer fledermaussuppe angefangen hat	intent:myths
ist es ein mythos, dass corona vom pangolin übertragen wurde	intent:myths
ist es ein mythos, dass covid-19 bei kinder nicht auftretten kann	intent:myths
ist es ein mythos, dass covid-19 im labor entwickelt war	intent:myths
ist es ein mythos, dass das coronavirus bei jungen menschen nicht betroffen ist	intent:myths
ist es ein mythos, dass das coronavirus in einem labor hergestellt wurde	intent:myths
ist es ein mythos, dass das virus unter der sonne ausstirbt	intent:myths
ist es ein mythos, dass des coronavirus ursprünglich von einem wildtiermarkt in china stammt	intent:myths
ist es ein mythos, dass fledermäuse schuld sind an der entstehung von corona	intent:myths
ist es ein mythos, dass junge leute immun sind	intent:myths
ist es ein mythos, dass kinder sich nicht anstecken können	intent:myths
ist es ein mythos, dass nur alte leute an corona sterben	intent:myths
ist es falsch, dass das coronavirus über pakete übertragen werden kann	intent:myths
ist es mythos, dass kinder sich nicht erkranken können	intent:myths
ist es nur ein märchen, dass coronavirus von der fledermaus kam	intent:myths
ist es wahr, dass covid neunzehn aus einem chinesischen labor entstammt	intent:myths
ist es wahr, dass das corona virus aus einem labor entsprungen ist	intent:myths
ist es wahr, dass der coronaerreger aus einem chinesischen labor stammt	intent:myths
man munkelt, ausserirdische haben uns das coronavirus gesendet	intent:myths
mythos, dass der virus im labor gez??chtet worden ist	intent:myths
stimmt es, dass corona aus einem labor stammt	intent:myths
stimmt es, dass die chinesen schuld am coronavirus sind	intent:myths
welche falschinformationen kursieren rund um das coronavirus	intent:myths
woher weiss ich, ob die information richtig ist	intent:myths
china-mythos über das coronavirus aus dem labor	intent:myths
erzähl mir mythen über coronavirus	intent:myths
gib mir die aktuellsten mythen zu corona an	intent:myths
gib mir informationen über mythen über das coronavirus	intent:myths
gibt es mythen über das coronavirus	intent:myths
ich möchte die mythen über coronavirus kennen	intent:myths
informationen zu den bekanntesten mythen über den coronavirus	intent:myths
ist es ein mythos das corona für kinder nicht gefährlich ist	intent:myths
nenn mir aktuelle gerüchte über corona	intent:myths
nenne mythen über das coronavirus	intent:myths
stirbt das coronavirus wenn draußen 26 grad ist	intent:myths
suche mir die aktuelle mythen über das coronavirus bitte	intent:myths
was erzählt man sich über das coronavirus	intent:myths
was für mythen über das coronavirus gibt es	intent:myths
was sind falsche mythen zum coronavirus	intent:myths
was sind fehlinformationen die gerade über corona kursieren	intent:myths
welche coronavirus mythen sind gerade aktuell	intent:myths
welche fake news werden derzeit verbreitet	intent:myths
welche falschinformationen kursieren über das coronavirus	intent:myths
welche falschinformationen werden über das coronavirus verbreitet	intent:myths
welche häufigen falschnachrichten gibt es über covid	intent:myths
welche informationen zu corona sind mythen	intent:myths
welche lügen gibt es über corona	intent:myths
welche sind die derzeit aktuellen mythen über das coronavirus	intent:myths
welche theorien gibt es momentan bezüglich des virus	intent:myths
welche verschwörungstheorien gibt es zum coronavirus	intent:myths
welche verschwörungstheorien ranken sich um covid-19	intent:myths
wie lauten die aktuellen mythen rund um das coronavirus	intent:myths
wie lauten die corona mythen	intent:myths
wo kann ich alle mythen des coronavirusses sehen	intent:myths
wo kann man mythen über das virus finden	intent:myths
wurde das coronavirus durch 5g ausgelöst	intent:myths
wurde das coronavirus im labor hergestellt	intent:myths
zähle mythen über das coronavirus auf	intent:myths
zeige mir ein paar mythen über corona	intent:myths
bekomme ich mein geld zurück, wenn ich nicht fliegen kann	intent:travel
benötige ich eine gesichtsmaske, wenn ich mit öffentlichen verkehrsmittel fahre	intent:travel
darf ich von frankfurt nach berlin fahren, um meinen vater zu besuchen	intent:travel
ich möchte im august nach thailand fliegen, wird das möglich sein	intent:travel
ist es noch sicher, die öffentlichen zu benutzen	intent:travel
ist es sicher, in italienischen provinzen umherzureisen	intent:travel
ist es sicher, mit dem bus innerhalb deutschland zu reisen	intent:travel
ist es vor coronavirus sicher, jetzt mit dem flugzeug nach europa zu reisen	intent:travel
kann man noch mit taxis, busse und züge fahren	intent:travel
sollte ich warten, bis mein reiseveranstalter meine reise absagt	intent:travel
was ist derzeit sicherer, mit dem zug oder mit dem flugzeug zu reisen	intent:travel
was ist ein triftiger grund, um in die schweiz zu reisen	intent:travel
was muss ich beachten, wenn ich mit dem zug reise	intent:travel
was muss ich tun, um an diesen daten reisen zu können	intent:travel
was soll man tun, wenn man eine reise macht	intent:travel
welche auswirkungen hat das virus auf reisen	intent:travel
welche vorsichtsmaßnahmen sollte ich treffen, wenn ich nach münchen fahre	intent:travel
ab wann ist das reisen nach england im hinblick auf corona wieder unbedenklich	intent:travel
aktuelle reisebeschränkungen innerhalb deutschlands	intent:travel
bekomme ich das geld für mein zugticket wegen corona zurück	intent:travel
darf ich eigentlich ins ausland und dann wieder zurück ohne quarantäne	intent:travel
darf ich trotz der bestehenden reisewarnungen seitens der bundesregierung verreisen	intent:travel
für welche länder gelten besondere reisebestimmungen	intent:travel
hat die usa noch eine einreisebeschränkung	intent:travel
ich benötige hinweise zu einer bevorstehenden reise	intent:travel
in welche bundesländer innerhalb deutschlands darf ich noch reisen	intent:travel
in welche länder darf ich während der coronakrise reisen	intent:travel
in welche länder kann man derzeit nicht einreisen	intent:travel
in welche länder kann man noch reisen	intent:travel
in welches europöisches land kann ich noch reisen	intent:travel
informationen über reisen und corona	intent:travel
ist der öffentlicher personennahverkehr gestrichen	intent:travel
ist die grenze zwischen deutschland und der schweiz wegen corona geschlossen	intent:travel
ist ein urlaub im september möglich	intent:travel
ist eine fürt mit den öffentlichen verkehrsmitteln sicher	intent:travel
ist eine reise mit dem zug momentan sicher	intent:travel
ist es besser seinen sommerurlaub zu stornieren	intent:travel
ist es empfohlen momentan von stadt zu stadt zu reisen	intent:travel
ist es gefährlich mit dem flugzeug nach frankreich zu fliegen	intent:travel
ist es möglich noch mit dem flugzeug zu verreisen	intent:travel
ist es sicher mit öffentlichen verkehrsmitteln zu reisen	intent:travel
ist es sicher mit dem auto durch europa zu fahren	intent:travel
ist es sicher zur zeit in die türkei zu reisen	intent:travel
ist mein flug nach china jetzt gestrichen	intent:travel
ist mein urlaub in der türkei gecancelt	intent:travel
kann ich öffentliche verkehrsmittel nutzen	intent:travel
kann ich als rumänischer erntehelfer nach deutschland zur arbeit gehen	intent:travel
kann ich bedenkenlos den nahverkehr hier nutzen	intent:travel
kann ich im herbst in deutschland in urlaub fahren	intent:travel
kann ich im juli nach österreich reisen	intent:travel
kann ich in europa wegen des coronavirus die grenzen auf der straße überschreiten	intent:travel
kann ich in hannover mit dem bus fahren	intent:travel
muss ich wegen corona meine reise stornieren	intent:travel
soll ich meine bevorstehende reise in die schweiz wegen corona streichen	intent:travel
soll ich meine gebuchten flüge stornieren	intent:travel
sollte ich meine reise nach frankreich absagen	intent:travel
welche einschränkungen gibt es nach italien zu reisen	intent:travel
welche transportmitteln kann man in dieser zeit bedenklos nutzen	intent:travel
wie kann man eine reiseberatung bekommen	intent:travel
wie sicher ist eine reise innerhalb der eu	intent:travel
wie sieht es mit dem zugverkehr aus	intent:travel
wie sind die sicherheitsbestimmungen im zug während corona	intent:travel
wird mein urlaub in ein risikogebiet gestrichen	intent:travel
wohin kann ich während der coronakrise reisen	intent:travel
aktuelle informationen über den virus, bitte	intent:news_and_press
bitte gebe mir eine zusammenfassung über das, was heute in der deutschen presse über covid-1 berichtet wurde	intent:news_and_press
gib mir bitte information über die neuesten coronavirus-updates in deutschland	intent:news_and_press
ich möchte wissen, was die aktuellen entwicklungen ist	intent:news_and_press
neueste presseinformationen über das virus	intent:news_and_press
welche neuigkeiten gibt es zu corona	intent:news_and_press
welche neuigkeiten zum coronavirus gibt es	intent:news_and_press
wie ist der aktuelle status von washington, der von der presse veröffentlicht wurde	intent:news_and_press
wie ist die aktuelle entwicklung in der lombardei	intent:news_and_press
zeig mir das neueste über corona, bitte	intent:news_and_press
aktuelle meldungen zum coronavirus	intent:news_and_press
aktuelle nachrichten über coronavirus in münchen	intent:news_and_press
aktuelle nachrichten zum thema corona	intent:news_and_press
aktuelle nachrichten zum virus in deutschland	intent:news_and_press
aktuelle pressemeldungen zur coronakrise in bayern	intent:news_and_press
aktueller entwicklungsstand des coronavirus	intent:news_and_press
aktuellste pressekonferenz vom robert-koch-institut	intent:news_and_press
bitte die aktuellen nachrichten zu corona	intent:news_and_press
bitte gib mir die letzten neuigkeiten über covid19 in stuttgart	intent:news_and_press
bitte halte mich auf dem stand	intent:news_and_press
bitte informiere mich über die neuesten entwicklungen	intent:news_and_press
bitte pressemeldungen zum coronavirus	intent:news_and_press
bitte schick mir die aktuelle nachrichten weltweit über das coronavirus	intent:news_and_press
bitte schick mir die tägliche corona nachrichten	intent:news_and_press
bitte schicke mir die nachrichten zu dem virus	intent:news_and_press
bitte zeig mir nachrichten über die corona-impfstoffentwicklung	intent:news_and_press
bitte zeige mir die aktuellsten news über das coronavirus in new york	intent:news_and_press
corona aktuelle informationen in deutschland	intent:news_and_press
coronavirus - nachrichten von heute	intent:news_and_press
der heutige stand der informationen über berlin bezüglich des coronavirus	intent:news_and_press
die aktuelle nachrichten über coronavirus bitte	intent:news_and_press
die aktuelle nachrichten über das coronavirus in deutschland	intent:news_and_press
die aktuellen mitteilungen der who bitte	intent:news_and_press
ein aktuelleübericht über das virus in europa bitte	intent:news_and_press
erzähl mir über die neusten nachrichten zum coronavirus	intent:news_and_press
erzähle die neusten nachrichten	intent:news_and_press
erzählen sie mir die neuesten nachrichten über den virus	intent:news_and_press
gabs heute was neues zu corona	intent:news_and_press
gib mir aktuelle nachrichten über das coronavirus	intent:news_and_press
gib mir die aktuellen nachrichten zu corona in deutschland	intent:news_and_press
gib mir die neuesten nachrichten über corona in südtirol	intent:news_and_press
gibt es aktuelle corona news	intent:news_and_press
gibt es bereits lockerungen rund um das coronavirus	intent:news_and_press
gibt es eine aktuelle pressemeldung zum coronavirus	intent:news_and_press
gibt es eine neue stellungnahme der bundesregierung	intent:news_and_press
gibt es etwas neues zum virus in deutschland	intent:news_and_press
gibt es neue pressemitteilungen zum coronavirus in deutschland	intent:news_and_press
gibt es neuigkeiten von dem coronavirus in deutschland	intent:news_and_press
halte mich über die entwicklungen zum coronavirus auf dem laufenden	intent:news_and_press
kannst du mir ein update über die aktuellen corona-entwicklungen geben	intent:news_and_press
schick mir alle wichtigen news über dem coronavirus zu	intent:news_and_press
was gibt es neuigkeiten über coronavirus in deutschland	intent:news_and_press
was ist die neuste pressemitteilung der bundesregierung über corona	intent:news_and_press
was sagt das robert-koch-institut über neue entwicklungen zur corona pandemie	intent:news_and_press
was sind die aktuellen news bezüglich coronavirus in baden-württemberg	intent:news_and_press
was sind die neusten presseinfos zu corona	intent:news_and_press
was sind die neusten verordnungen im zusammenhang mit corona in baden-württemberg	intent:news_and_press
welche neuen fachartikel gibt es zu corona	intent:news_and_press
welche neuen informationen gibt es bezüglich des corona virus	intent:news_and_press
welche updates gibt es weltweit zum coronavirus	intent:news_and_press
welchen neusten entscheidungen hat die politik in  nrw zur corona getroffen	intent:news_and_press
wie lauten die aktuellen zahlen und nachrichten für deutschland	intent:news_and_press
wie lauten die neuigkeiten vom coronavirus	intent:news_and_press
wie lauten die neusten schlagzeilen zur corona-pandemie	intent:news_and_press
wie sehen die aktuellen nachrichten zu corona in deutschland aus	intent:news_and_press
wie sind die aktuellen neuigkeiten zum coronavirus	intent:news_and_press
zeig mir die aktuellen updates über das coronavirus in den usa	intent:news_and_press
zeig mir die neueste nachricht zu covid neunzehn in der ntv-app	intent:news_and_press
zeig mir weltweite nachrichten bezüglich des coronavirus	intent:news_and_press
zeige bitte die neusten updates zu dem coronavirus	intent:news_and_press
zeige mir die neuesten nachrichten zum coronavirus	intent:news_and_press
bitte teile diese nachricht	intent:share
sende den who bot auf mein profil	intent:share
wie kann ich den link weiterleiten, damit er geteilt wird	intent:share
wie teile ich das jetzt	intent:share
bitte als email link weiterleiten an meine familie	intent:share
bitte den bot weiterleiten	intent:share
bitte den inhalt teilen	intent:share
bitte diese information via facebook teilen	intent:share
bitte diese information vom who mit meiner kontaktliste teilen	intent:share
bitte link von der who teilen	intent:share
bitte niemals diesen bot trauen	intent:share
bitte schicke diesen link meinen freunden	intent:share
bitte schicke einen link über whatsapp an stephan	intent:share
bitte sende diesen link meinen freunden	intent:share
bitte teil das hier für mich	intent:share
bitte teil den bot	intent:share
bitte teil diese info in einer direktnachricht	intent:share
bitte teile die seite über whatsapp	intent:share
bitte teile dies auf meiner social media seite	intent:share
bitte teile diesen link bei instagram in meiner story	intent:share
bitte teile diesen screenshot	intent:share
bitte who-bot teilen	intent:share
diese fakten möchte ich teilen	intent:share
diese service würde ich gerne teilen	intent:share
ich möchte diese informationen teilen	intent:share
ich möchte diese nachricht teilen	intent:share
ich möchte diesen beitrag teilen	intent:share
ich möchte diesen bot jetzt auf facebook teilen	intent:share
ich möchte diesen weblink mit meinen freunden teilen	intent:share
ich würde gerne den who bot mit anderen services verbinden	intent:share
ich würde gerne einen link zur aktuellen statistiken teilen	intent:share
ich will diese information geteilt haben	intent:share
ich will diesen link teilen	intent:share
ich will diesen service teilen	intent:share
könntest du diesen link bitte teilen	intent:share
kannst du bitte diesen nachricht teilen	intent:share
kannst du deinen service bitte auf meinen social media plattformen teilen	intent:share
poste diese info für mich auf facebook	intent:share
schicke diese seite via whatsapp an mama	intent:share
schicke diesen artikel weiter an meinen kollegen	intent:share
sende deinen service an meine freunde weiter	intent:share
teil den bot auf allen bekannten sozialen mediaplattformen	intent:share
teile das bitte mit meinen facebook freunden	intent:share
teile den link auf facebook bitte	intent:share
teile den service auf den sozialen medien	intent:share
teile den who bot auf facebook	intent:share
teile den who bot mit meiner whatsapp sportgruppe	intent:share
teile den who-bot in all meinen sozialen medien	intent:share
teile die informationen über das virus	intent:share
teile die informationen auf meinen social media kanälen	intent:share
teile die informationen der who in deinen sozialen medien	intent:share
teile diese information von der weltgesundheitsorganisation auf facebook	intent:share
teile diese servicenummer mit meinen kontakten auf facebook	intent:share
teile diesen chat auf facebook	intent:share
teile diesen nachrichtenlink mit meinen kontakten	intent:share
teilen sie die neuesten nachrichten über coronavirus von der who auf meinem facebook	intent:share
verbreite die wichtigen who informationen über deine nachrichtenkanäle	intent:share
verlinke den artikel auf meiner seite	intent:share
wie kann ich den link auf facebook teilen	intent:share
wie kann ich den service mit meinen whatsapp-kontakten teilen	intent:share
wie kann ich den who bot jemandem schicken	intent:share
wie kann ich dies nachricht vom who mit meinen freunden teilen	intent:share
wie man diesen chat mit anderen teilt	intent:share
wie man diesen link in instagram teilt	intent:share
wie teile ich diesen service	intent:share
wie verlinke ich den who bot	intent:share
alles klar, wir können loslegen	intent:hi
captain corona, wie geht es dir	intent:hi
corona, was geht ab	intent:hi
grüß gott, corona	intent:hi
guten morgen corona doktor, wie gehts	intent:hi
guten tag, doktor bot	intent:hi
hallo corona, wie geht es dir	intent:hi
hallo, wie geht es dir	intent:hi
hi, doktor corona	intent:hi
moin, dok	intent:hi
morgen, herr corona	intent:hi
na, alles gut	intent:hi
einen wunderschönen guten morgen corona-doktor	intent:hi
guten abend kumpel	intent:hi
guten abend mein corona experte	intent:hi
guten morgen corona doktor	intent:hi
guten morgen corona spezialist	intent:hi
guten morgen coronabot	intent:hi
guten morgen corona-fachmann	intent:hi
guten morgen lieber bot	intent:hi
guten morgen mein corona-berater	intent:hi
guten tag coronabot	intent:hi
guten tag doktor corona	intent:hi
hallöchen doktor	intent:hi
hallöchen frau corona	intent:hi
hallo allwissender held	intent:hi
hallo bot doktor	intent:hi
hallo chatbot	intent:hi
hallo chinesisches virus	intent:hi
hallo corona experte	intent:hi
hallo corona king	intent:hi
hallo corona-bot	intent:hi
hallo corona-kämpfer	intent:hi
hallo coronavirus	intent:hi
hallo coronazentrum	intent:hi
hallo covid bot	intent:hi
hallo covid-19	intent:hi
hallo doktor corona	intent:hi
hallo dr. corona	intent:hi
hallo helferlein	intent:hi
hallo herr corona	intent:hi
hallo lieber bot	intent:hi
hallo mein corona doktor	intent:hi
hallo mein lieblingsdoctor	intent:hi
hallo spion	intent:hi
hey assistent	intent:hi
hey codoc	intent:hi
hey corona doktor	intent:hi
hey corona roboter	intent:hi
hey corona-arzt	intent:hi
hey doktor covid	intent:hi
hi bot	intent:hi
hi corona buddy	intent:hi
hi corona-bot	intent:hi
hi corona-doktor	intent:hi
hi covid-doc	intent:hi
huhu doktor	intent:hi
ich grüße dich corona	intent:hi
mahlzeit doktor	intent:hi
moin codo	intent:hi
moin corona bot	intent:hi
moin corona-doc	intent:hi
moin doktor	intent:hi
moin dr.corona	intent:hi
morgen doc	intent:hi
sanfte grüße fremder	intent:hi
schönen guten tag herr doktor	intent:hi
servus covid-doc	intent:hi
servus mein freund	intent:hi
was geht ab bot	intent:hi
wie geht es dir corona doktor	intent:hi
alles klar, vielen dank für diese information	intent:okay_thanks
danke bot, für diese info	intent:okay_thanks
danke doc, die infos waren sehr hilfreich	intent:okay_thanks
danke doktor corona, das war hilfreich	intent:okay_thanks
danke für deine informationen, corona doc	intent:okay_thanks
danke für diese information, doc	intent:okay_thanks
danke für ihre hilfe, bis zur nächsten sitzung	intent:okay_thanks
danke, allwissendes virenlexikon	intent:okay_thanks
danke, das war interessant	intent:okay_thanks
danke, das wäre es für heute	intent:okay_thanks
danke, das wollte ich wissen	intent:okay_thanks
danke, dass du mir geholfen hast	intent:okay_thanks
danke, dass du mir so viele infos gegeben hast	intent:okay_thanks
das war hilfreich, danke	intent:okay_thanks
das war sehr hilfreich, danke	intent:okay_thanks
gut gemacht, vielen dank	intent:okay_thanks
herzlichen dank für die infos doktor bot	intent:okay_thanks
hilfreiche infos, danke dir	intent:okay_thanks
ich bedanke mich recht herzlich bei dir, cora	intent:okay_thanks
liebes bot, vielen herzlichen dank	intent:okay_thanks
vielen dank für alles, doktor	intent:okay_thanks
vielen dank, du corona-doktor	intent:okay_thanks
vielen dank, lieber corona arzt	intent:okay_thanks
vielen dank, mein persoenlicher corona-berater	intent:okay_thanks
danke das hilft mir weiter	intent:okay_thanks
danke das wäre alles	intent:okay_thanks
danke dass du mir geholfen hast	intent:okay_thanks
danke für deine einschätzung	intent:okay_thanks
danke für deine hilfe	intent:okay_thanks
danke für den information	intent:okay_thanks
danke für die aktuelle nachrichten	intent:okay_thanks
danke für die ausführlichen informationen doktor corona	intent:okay_thanks
danke für die beantwortung meiner fragen	intent:okay_thanks
danke für die hilfe dok	intent:okay_thanks
danke für die infos corona	intent:okay_thanks
danke für diese informationen	intent:okay_thanks
danke für diese report	intent:okay_thanks
danke für ihrer leistungen	intent:okay_thanks
danke professor corona	intent:okay_thanks
danke vielmals für deine hilfe	intent:okay_thanks
dankeschön bot	intent:okay_thanks
dankeschön corona-bot	intent:okay_thanks
dankeschön corona-doktor	intent:okay_thanks
dankeschön für die viele hilfe	intent:okay_thanks
dankeschön mein helfer in der not	intent:okay_thanks
dankesehr für die infos doctor	intent:okay_thanks
das war sehr hilfreich doktor	intent:okay_thanks
ein großes dankeschön an dich	intent:okay_thanks
hab lieben dank für die infos	intent:okay_thanks
herzlichen dank für deine hilfe	intent:okay_thanks
ich bedanke mich bei dir herzlich	intent:okay_thanks
ich bedanke mich für deine unterstützung	intent:okay_thanks
ich danke dir für deine hilfe	intent:okay_thanks
ich danke dir für die coronanews	intent:okay_thanks
ich danke dir für die infos bot	intent:okay_thanks
ich möchte einfach mal danke sagen für all die wichtigen informationen	intent:okay_thanks
ich möchte ihnen für ihre hilfreiche information herzlich danken	intent:okay_thanks
ich möchte mich für deine informationen bedanken	intent:okay_thanks
vieen dank ihnen für wertvolle information	intent:okay_thanks
vielen dank corona experte für die vielen informationen	intent:okay_thanks
vielen dank für deine hilfe doktor corona	intent:okay_thanks
vielen dank für deine tipps doc	intent:okay_thanks
vielen dank für deine unterstützung	intent:okay_thanks
vielen dank für die kompetente hilfe	intent:okay_thanks
vielen dank für die geteilten informationen	intent:okay_thanks
vielen dank lieber bot für deine hilfestellung	intent:okay_thanks
vielen lieben dank doktor	intent:okay_thanks
vielen lieben dank für die auskunft	intent:okay_thanks
war nice von dir	intent:okay_thanks
an welcher stelle muss man sich wenden, um für italien zu spenden	intent:donate
ich möchte an ein land geld spenden, dass besonders vom coronavirus betroffen ist	intent:donate
ich möchte jetzt geld spenden, gegen die corona ausbreitung in deutschland	intent:donate
nenn mir soziale einrichtungen in meiner nähe, an die ich spenden kann	intent:donate
sag mir bitte, wie spendet man	intent:donate
spenden in der coronakrise, wie geht es	intent:donate
was muss ich tun, um für den yemen zu spenden	intent:donate
wie spende ich für tiere, die wegen corona kein futter bekommen	intent:donate
wo kann ich spenden, um die bekämpfung des virus zu unterst??tzen	intent:donate
ich möchte an die hilfsorganisation für gesundheitspersonal spenden	intent:donate
an wen kann ich geld spenden	intent:donate
bitte veranlasse eine finanzielle unterstützung für die usa	intent:donate
finanzielle förderung für das flüchtlingscamp auf lesbos bereitstellen	intent:donate
geldspenden für albanien bereitstellen	intent:donate
gibt es ein spendenkonto für coronahilfe	intent:donate
gibt es spendenaktionen in deutschland	intent:donate
gibt es spendenkonten für coronaopfer	intent:donate
ich möchte den menschen in der lombardei mit einer spende helfen	intent:donate
ich möchte die krankenhäuser finanzielle unterstützen	intent:donate
ich möchte flüchtlingslager in griechenland wegen corona unterstützen	intent:donate
ich möchte geld an die arme länder spenden	intent:donate
ich möchte geld für covid 19 ausgeben	intent:donate
ich möchte gerne finanziell die region lombardei in italien unterstützen	intent:donate
ich möchte gerne geld spenden für betroffene kleinunternehmen in deutschland. wie geht das	intent:donate
ich möchte mit einer spende die corona-prävention in afrika unterstützen	intent:donate
ich stelle eine finanzielle unterstützung bereit	intent:donate
ich würde gerne eine angemessene summe für kindern in afrika spenden	intent:donate
ich würde gerne eine finanzielle fürderung für spanien bereitstellen	intent:donate
ich würde gerne für die coronakrise spenden	intent:donate
ich will der musikszene in der coronakriese helfen	intent:donate
kann ich dich mit einer spende unterstützen	intent:donate
kann ich für corona-hilfsprojekte in usa apenden	intent:donate
kann man geld für new yorks krankenhaeuser spenden	intent:donate
mach eine spende an den fonds für das italienische krankenhaus	intent:donate
spende für die corona-initiative in deutschland	intent:donate
welche hilfürganisationen benötigen spenden	intent:donate
welche länder brauchen die meisten corona-spenden	intent:donate
welche möglichkeiten gibt es zu spenden	intent:donate
wie fürdere ich die mitarbeiter des gesundheitsystems	intent:donate
wie kann ich coronaopfer finanziell unterstützen	intent:donate
wie kann ich etwas für italien spenden	intent:donate
wie kann ich für corona forschung spenden	intent:donate
wie kann ich für die bekämpfung des virus spenden	intent:donate
wie kann ich geld an italiener spenden	intent:donate
wie kann ich geld für betroffene länder spenden	intent:donate
wie kann ich geld für ein bestimmtes coronaprojekt spenden	intent:donate
wie kann ich risikogebieten geld spenden	intent:donate
wie kann ich spanien mit einer spende unterstützen	intent:donate
wie man geld für coronavirus in hyderabad spendet	intent:donate
wie sende ich spenden an lokale unternehmen	intent:donate
wie spende ich an diese organisation	intent:donate
wie spende ich atemschutzmasken	intent:donate
wie spende ich geld an afrika	intent:donate
wie spende ich geld für initiativen in deutschland	intent:donate
wie spendet man für die corona-hilfe in oaxaca	intent:donate
wie spendet man für kinder in not in afrika	intent:donate
wie stelle ich geld bereit für den guten zweck	intent:donate
wo kann ich am besten für leute in not spenden	intent:donate
wo kann ich am besten geld für corona spenden	intent:donate
wo kann ich für kinder spenden	intent:donate
wo spende ich für coronavirus	intent:donate
wo spende ich für die corona-forschung	intent:donate
wohin kann ich meine spende schicken	intent:donate
zeige mir die offizielle spendenseite	intent:donate
